Date_reported,Country_code,Country,WHO_region,New_cases,Cumulative_cases,New_deaths,Cumulative_deaths
2020-03-08 00:00:00+00:00,BD,Bangladesh,SEARO,3,3,0,0
2020-03-09 00:00:00+00:00,BD,Bangladesh,SEARO,0,3,0,0
2020-03-10 00:00:00+00:00,BD,Bangladesh,SEARO,0,3,0,0
2020-03-11 00:00:00+00:00,BD,Bangladesh,SEARO,0,3,0,0
2020-03-12 00:00:00+00:00,BD,Bangladesh,SEARO,0,3,0,0
2020-03-13 00:00:00+00:00,BD,Bangladesh,SEARO,0,3,0,0
2020-03-14 00:00:00+00:00,BD,Bangladesh,SEARO,0,3,0,0
2020-03-15 00:00:00+00:00,BD,Bangladesh,SEARO,0,3,0,0
2020-03-16 00:00:00+00:00,BD,Bangladesh,SEARO,5,8,0,0
2020-03-17 00:00:00+00:00,BD,Bangladesh,SEARO,0,8,0,0
2020-03-18 00:00:00+00:00,BD,Bangladesh,SEARO,2,10,0,0
2020-03-19 00:00:00+00:00,BD,Bangladesh,SEARO,7,17,1,1
2020-03-20 00:00:00+00:00,BD,Bangladesh,SEARO,0,17,0,1
2020-03-21 00:00:00+00:00,BD,Bangladesh,SEARO,7,24,1,2
2020-03-22 00:00:00+00:00,BD,Bangladesh,SEARO,0,24,0,2
2020-03-23 00:00:00+00:00,BD,Bangladesh,SEARO,3,27,0,2
2020-03-24 00:00:00+00:00,BD,Bangladesh,SEARO,12,39,2,4
2020-03-25 00:00:00+00:00,BD,Bangladesh,SEARO,0,39,0,4
2020-03-26 00:00:00+00:00,BD,Bangladesh,SEARO,5,44,1,5
2020-03-27 00:00:00+00:00,BD,Bangladesh,SEARO,4,48,0,5
2020-03-28 00:00:00+00:00,BD,Bangladesh,SEARO,0,48,0,5
2020-03-29 00:00:00+00:00,BD,Bangladesh,SEARO,0,48,0,5
2020-03-30 00:00:00+00:00,BD,Bangladesh,SEARO,1,49,0,5
2020-03-31 00:00:00+00:00,BD,Bangladesh,SEARO,0,49,0,5
2020-04-01 00:00:00+00:00,BD,Bangladesh,SEARO,5,54,1,6
2020-04-02 00:00:00+00:00,BD,Bangladesh,SEARO,2,56,0,6
2020-04-03 00:00:00+00:00,BD,Bangladesh,SEARO,5,61,0,6
2020-04-04 00:00:00+00:00,BD,Bangladesh,SEARO,9,70,2,8
2020-04-05 00:00:00+00:00,BD,Bangladesh,SEARO,18,88,0,8
2020-04-06 00:00:00+00:00,BD,Bangladesh,SEARO,35,123,4,12
2020-04-07 00:00:00+00:00,BD,Bangladesh,SEARO,41,164,5,17
2020-04-08 00:00:00+00:00,BD,Bangladesh,SEARO,54,218,3,20
2020-04-09 00:00:00+00:00,BD,Bangladesh,SEARO,112,330,1,21
2020-04-10 00:00:00+00:00,BD,Bangladesh,SEARO,94,424,6,27
2020-04-11 00:00:00+00:00,BD,Bangladesh,SEARO,58,482,3,30
2020-04-12 00:00:00+00:00,BD,Bangladesh,SEARO,139,621,4,34
2020-04-13 00:00:00+00:00,BD,Bangladesh,SEARO,182,803,5,39
2020-04-14 00:00:00+00:00,BD,Bangladesh,SEARO,209,1012,7,46
2020-04-15 00:00:00+00:00,BD,Bangladesh,SEARO,219,1231,4,50
2020-04-16 00:00:00+00:00,BD,Bangladesh,SEARO,341,1572,10,60
2020-04-17 00:00:00+00:00,BD,Bangladesh,SEARO,266,1838,15,75
2020-04-18 00:00:00+00:00,BD,Bangladesh,SEARO,306,2144,9,84
2020-04-19 00:00:00+00:00,BD,Bangladesh,SEARO,312,2456,7,91
2020-04-20 00:00:00+00:00,BD,Bangladesh,SEARO,492,2948,10,101
2020-04-21 00:00:00+00:00,BD,Bangladesh,SEARO,434,3382,9,110
2020-04-22 00:00:00+00:00,BD,Bangladesh,SEARO,390,3772,10,120
2020-04-23 00:00:00+00:00,BD,Bangladesh,SEARO,414,4186,7,127
2020-04-24 00:00:00+00:00,BD,Bangladesh,SEARO,503,4689,4,131
2020-04-25 00:00:00+00:00,BD,Bangladesh,SEARO,309,4998,9,140
2020-04-26 00:00:00+00:00,BD,Bangladesh,SEARO,418,5416,5,145
2020-04-27 00:00:00+00:00,BD,Bangladesh,SEARO,497,5913,7,152
2020-04-28 00:00:00+00:00,BD,Bangladesh,SEARO,549,6462,3,155
2020-04-29 00:00:00+00:00,BD,Bangladesh,SEARO,641,7103,8,163
2020-04-30 00:00:00+00:00,BD,Bangladesh,SEARO,564,7667,5,168
2020-05-01 00:00:00+00:00,BD,Bangladesh,SEARO,571,8238,2,170
2020-05-02 00:00:00+00:00,BD,Bangladesh,SEARO,552,8790,5,175
2020-05-03 00:00:00+00:00,BD,Bangladesh,SEARO,665,9455,2,177
2020-05-04 00:00:00+00:00,BD,Bangladesh,SEARO,688,10143,5,182
2020-05-05 00:00:00+00:00,BD,Bangladesh,SEARO,786,10929,1,183
2020-05-06 00:00:00+00:00,BD,Bangladesh,SEARO,790,11719,3,186
2020-05-07 00:00:00+00:00,BD,Bangladesh,SEARO,706,12425,0,186
2020-05-08 00:00:00+00:00,BD,Bangladesh,SEARO,709,13134,20,206
2020-05-09 00:00:00+00:00,BD,Bangladesh,SEARO,636,13770,8,214
2020-05-10 00:00:00+00:00,BD,Bangladesh,SEARO,887,14657,14,228
2020-05-11 00:00:00+00:00,BD,Bangladesh,SEARO,1034,15691,11,239
2020-05-12 00:00:00+00:00,BD,Bangladesh,SEARO,969,16660,11,250
2020-05-13 00:00:00+00:00,BD,Bangladesh,SEARO,1162,17822,19,269
2020-05-14 00:00:00+00:00,BD,Bangladesh,SEARO,1041,18863,14,283
2020-05-15 00:00:00+00:00,BD,Bangladesh,SEARO,1202,20065,15,298
2020-05-16 00:00:00+00:00,BD,Bangladesh,SEARO,930,20995,16,314
2020-05-17 00:00:00+00:00,BD,Bangladesh,SEARO,0,20995,0,314
2020-05-18 00:00:00+00:00,BD,Bangladesh,SEARO,2875,23870,35,349
2020-05-19 00:00:00+00:00,BD,Bangladesh,SEARO,1251,25121,21,370
2020-05-20 00:00:00+00:00,BD,Bangladesh,SEARO,1617,26738,16,386
2020-05-21 00:00:00+00:00,BD,Bangladesh,SEARO,1773,28511,22,408
2020-05-22 00:00:00+00:00,BD,Bangladesh,SEARO,1694,30205,24,432
2020-05-23 00:00:00+00:00,BD,Bangladesh,SEARO,1873,32078,20,452
2020-05-24 00:00:00+00:00,BD,Bangladesh,SEARO,1532,33610,28,480
2020-05-25 00:00:00+00:00,BD,Bangladesh,SEARO,1975,35585,21,501
2020-05-26 00:00:00+00:00,BD,Bangladesh,SEARO,1166,36751,21,522
2020-05-27 00:00:00+00:00,BD,Bangladesh,SEARO,1541,38292,22,544
2020-05-28 00:00:00+00:00,BD,Bangladesh,SEARO,2029,40321,15,559
2020-05-29 00:00:00+00:00,BD,Bangladesh,SEARO,2523,42844,23,582
2020-05-30 00:00:00+00:00,BD,Bangladesh,SEARO,1764,44608,28,610
2020-05-31 00:00:00+00:00,BD,Bangladesh,SEARO,2545,47153,40,650
2020-06-01 00:00:00+00:00,BD,Bangladesh,SEARO,0,47153,0,650
2020-06-02 00:00:00+00:00,BD,Bangladesh,SEARO,2381,49534,22,672
2020-06-03 00:00:00+00:00,BD,Bangladesh,SEARO,2911,52445,37,709
2020-06-04 00:00:00+00:00,BD,Bangladesh,SEARO,2695,55140,37,746
2020-06-05 00:00:00+00:00,BD,Bangladesh,SEARO,2423,57563,35,781
2020-06-06 00:00:00+00:00,BD,Bangladesh,SEARO,2828,60391,30,811
2020-06-07 00:00:00+00:00,BD,Bangladesh,SEARO,2635,63026,35,846
2020-06-08 00:00:00+00:00,BD,Bangladesh,SEARO,2743,65769,42,888
2020-06-09 00:00:00+00:00,BD,Bangladesh,SEARO,2735,68504,42,930
2020-06-10 00:00:00+00:00,BD,Bangladesh,SEARO,3171,71675,45,975
2020-06-11 00:00:00+00:00,BD,Bangladesh,SEARO,3190,74865,37,1012
2020-06-12 00:00:00+00:00,BD,Bangladesh,SEARO,3187,78052,37,1049
2020-03-06 00:00:00+00:00,BT,Bhutan,SEARO,1,1,0,0
2020-03-07 00:00:00+00:00,BT,Bhutan,SEARO,0,1,0,0
2020-03-08 00:00:00+00:00,BT,Bhutan,SEARO,0,1,0,0
2020-03-09 00:00:00+00:00,BT,Bhutan,SEARO,0,1,0,0
2020-03-10 00:00:00+00:00,BT,Bhutan,SEARO,0,1,0,0
2020-03-11 00:00:00+00:00,BT,Bhutan,SEARO,0,1,0,0
2020-03-12 00:00:00+00:00,BT,Bhutan,SEARO,0,1,0,0
2020-03-13 00:00:00+00:00,BT,Bhutan,SEARO,0,1,0,0
2020-03-14 00:00:00+00:00,BT,Bhutan,SEARO,0,1,0,0
2020-03-15 00:00:00+00:00,BT,Bhutan,SEARO,0,1,0,0
2020-03-16 00:00:00+00:00,BT,Bhutan,SEARO,0,1,0,0
2020-03-17 00:00:00+00:00,BT,Bhutan,SEARO,0,1,0,0
2020-03-18 00:00:00+00:00,BT,Bhutan,SEARO,0,1,0,0
2020-03-19 00:00:00+00:00,BT,Bhutan,SEARO,1,2,0,0
2020-03-20 00:00:00+00:00,BT,Bhutan,SEARO,0,2,0,0
2020-03-21 00:00:00+00:00,BT,Bhutan,SEARO,0,2,0,0
2020-03-22 00:00:00+00:00,BT,Bhutan,SEARO,0,2,0,0
2020-03-23 00:00:00+00:00,BT,Bhutan,SEARO,0,2,0,0
2020-03-24 00:00:00+00:00,BT,Bhutan,SEARO,0,2,0,0
2020-03-25 00:00:00+00:00,BT,Bhutan,SEARO,0,2,0,0
2020-03-26 00:00:00+00:00,BT,Bhutan,SEARO,1,3,0,0
2020-03-27 00:00:00+00:00,BT,Bhutan,SEARO,0,3,0,0
2020-03-28 00:00:00+00:00,BT,Bhutan,SEARO,0,3,0,0
2020-03-29 00:00:00+00:00,BT,Bhutan,SEARO,0,3,0,0
2020-03-30 00:00:00+00:00,BT,Bhutan,SEARO,1,4,0,0
2020-03-31 00:00:00+00:00,BT,Bhutan,SEARO,0,4,0,0
2020-04-01 00:00:00+00:00,BT,Bhutan,SEARO,0,4,0,0
2020-04-02 00:00:00+00:00,BT,Bhutan,SEARO,1,5,0,0
2020-04-03 00:00:00+00:00,BT,Bhutan,SEARO,0,5,0,0
2020-04-04 00:00:00+00:00,BT,Bhutan,SEARO,0,5,0,0
2020-04-05 00:00:00+00:00,BT,Bhutan,SEARO,0,5,0,0
2020-04-06 00:00:00+00:00,BT,Bhutan,SEARO,0,5,0,0
2020-04-07 00:00:00+00:00,BT,Bhutan,SEARO,0,5,0,0
2020-04-08 00:00:00+00:00,BT,Bhutan,SEARO,0,5,0,0
2020-04-09 00:00:00+00:00,BT,Bhutan,SEARO,0,5,0,0
2020-04-10 00:00:00+00:00,BT,Bhutan,SEARO,0,5,0,0
2020-04-11 00:00:00+00:00,BT,Bhutan,SEARO,0,5,0,0
2020-04-12 00:00:00+00:00,BT,Bhutan,SEARO,0,5,0,0
2020-04-13 00:00:00+00:00,BT,Bhutan,SEARO,0,5,0,0
2020-04-14 00:00:00+00:00,BT,Bhutan,SEARO,0,5,0,0
2020-04-15 00:00:00+00:00,BT,Bhutan,SEARO,0,5,0,0
2020-04-16 00:00:00+00:00,BT,Bhutan,SEARO,0,5,0,0
2020-04-17 00:00:00+00:00,BT,Bhutan,SEARO,0,5,0,0
2020-04-18 00:00:00+00:00,BT,Bhutan,SEARO,0,5,0,0
2020-04-19 00:00:00+00:00,BT,Bhutan,SEARO,0,5,0,0
2020-04-20 00:00:00+00:00,BT,Bhutan,SEARO,0,5,0,0
2020-04-21 00:00:00+00:00,BT,Bhutan,SEARO,1,6,0,0
2020-04-22 00:00:00+00:00,BT,Bhutan,SEARO,0,6,0,0
2020-04-23 00:00:00+00:00,BT,Bhutan,SEARO,1,7,0,0
2020-04-24 00:00:00+00:00,BT,Bhutan,SEARO,0,7,0,0
2020-04-25 00:00:00+00:00,BT,Bhutan,SEARO,0,7,0,0
2020-04-26 00:00:00+00:00,BT,Bhutan,SEARO,0,7,0,0
2020-04-27 00:00:00+00:00,BT,Bhutan,SEARO,0,7,0,0
2020-04-28 00:00:00+00:00,BT,Bhutan,SEARO,0,7,0,0
2020-04-29 00:00:00+00:00,BT,Bhutan,SEARO,0,7,0,0
2020-04-30 00:00:00+00:00,BT,Bhutan,SEARO,0,7,0,0
2020-05-01 00:00:00+00:00,BT,Bhutan,SEARO,0,7,0,0
2020-05-02 00:00:00+00:00,BT,Bhutan,SEARO,0,7,0,0
2020-05-03 00:00:00+00:00,BT,Bhutan,SEARO,0,7,0,0
2020-05-04 00:00:00+00:00,BT,Bhutan,SEARO,0,7,0,0
2020-05-05 00:00:00+00:00,BT,Bhutan,SEARO,0,7,0,0
2020-05-06 00:00:00+00:00,BT,Bhutan,SEARO,0,7,0,0
2020-05-07 00:00:00+00:00,BT,Bhutan,SEARO,0,7,0,0
2020-05-08 00:00:00+00:00,BT,Bhutan,SEARO,0,7,0,0
2020-05-09 00:00:00+00:00,BT,Bhutan,SEARO,0,7,0,0
2020-05-10 00:00:00+00:00,BT,Bhutan,SEARO,0,7,0,0
2020-05-11 00:00:00+00:00,BT,Bhutan,SEARO,2,9,0,0
2020-05-12 00:00:00+00:00,BT,Bhutan,SEARO,2,11,0,0
2020-05-13 00:00:00+00:00,BT,Bhutan,SEARO,0,11,0,0
2020-05-14 00:00:00+00:00,BT,Bhutan,SEARO,4,15,0,0
2020-05-15 00:00:00+00:00,BT,Bhutan,SEARO,5,20,0,0
2020-05-16 00:00:00+00:00,BT,Bhutan,SEARO,1,21,0,0
2020-05-17 00:00:00+00:00,BT,Bhutan,SEARO,0,21,0,0
2020-05-18 00:00:00+00:00,BT,Bhutan,SEARO,0,21,0,0
2020-05-19 00:00:00+00:00,BT,Bhutan,SEARO,0,21,0,0
2020-05-20 00:00:00+00:00,BT,Bhutan,SEARO,0,21,0,0
2020-05-21 00:00:00+00:00,BT,Bhutan,SEARO,0,21,0,0
2020-05-22 00:00:00+00:00,BT,Bhutan,SEARO,0,21,0,0
2020-05-23 00:00:00+00:00,BT,Bhutan,SEARO,0,21,0,0
2020-05-24 00:00:00+00:00,BT,Bhutan,SEARO,3,24,0,0
2020-05-25 00:00:00+00:00,BT,Bhutan,SEARO,3,27,0,0
2020-05-26 00:00:00+00:00,BT,Bhutan,SEARO,0,27,0,0
2020-05-27 00:00:00+00:00,BT,Bhutan,SEARO,0,27,0,0
2020-05-28 00:00:00+00:00,BT,Bhutan,SEARO,1,28,0,0
2020-05-29 00:00:00+00:00,BT,Bhutan,SEARO,3,31,0,0
2020-05-30 00:00:00+00:00,BT,Bhutan,SEARO,2,33,0,0
2020-05-31 00:00:00+00:00,BT,Bhutan,SEARO,10,43,0,0
2020-06-01 00:00:00+00:00,BT,Bhutan,SEARO,0,43,0,0
2020-06-02 00:00:00+00:00,BT,Bhutan,SEARO,4,47,0,0
2020-06-03 00:00:00+00:00,BT,Bhutan,SEARO,0,47,0,0
2020-06-04 00:00:00+00:00,BT,Bhutan,SEARO,0,47,0,0
2020-06-05 00:00:00+00:00,BT,Bhutan,SEARO,0,47,0,0
2020-06-06 00:00:00+00:00,BT,Bhutan,SEARO,1,48,0,0
2020-06-07 00:00:00+00:00,BT,Bhutan,SEARO,0,48,0,0
2020-06-08 00:00:00+00:00,BT,Bhutan,SEARO,11,59,0,0
2020-06-09 00:00:00+00:00,BT,Bhutan,SEARO,0,59,0,0
2020-06-10 00:00:00+00:00,BT,Bhutan,SEARO,0,59,0,0
2020-06-11 00:00:00+00:00,BT,Bhutan,SEARO,3,62,0,0
2020-06-12 00:00:00+00:00,BT,Bhutan,SEARO,0,62,0,0
2020-01-30 00:00:00+00:00,IN,India,SEARO,1,1,0,0
2020-01-31 00:00:00+00:00,IN,India,SEARO,0,1,0,0
2020-02-01 00:00:00+00:00,IN,India,SEARO,0,1,0,0
2020-02-02 00:00:00+00:00,IN,India,SEARO,1,2,0,0
2020-02-03 00:00:00+00:00,IN,India,SEARO,1,3,0,0
2020-02-04 00:00:00+00:00,IN,India,SEARO,0,3,0,0
2020-02-05 00:00:00+00:00,IN,India,SEARO,0,3,0,0
2020-02-06 00:00:00+00:00,IN,India,SEARO,0,3,0,0
2020-02-07 00:00:00+00:00,IN,India,SEARO,0,3,0,0
2020-02-08 00:00:00+00:00,IN,India,SEARO,0,3,0,0
2020-02-09 00:00:00+00:00,IN,India,SEARO,0,3,0,0
2020-02-10 00:00:00+00:00,IN,India,SEARO,0,3,0,0
2020-02-11 00:00:00+00:00,IN,India,SEARO,0,3,0,0
2020-02-12 00:00:00+00:00,IN,India,SEARO,0,3,0,0
2020-02-13 00:00:00+00:00,IN,India,SEARO,0,3,0,0
2020-02-14 00:00:00+00:00,IN,India,SEARO,0,3,0,0
2020-02-15 00:00:00+00:00,IN,India,SEARO,0,3,0,0
2020-02-16 00:00:00+00:00,IN,India,SEARO,0,3,0,0
2020-02-17 00:00:00+00:00,IN,India,SEARO,0,3,0,0
2020-02-18 00:00:00+00:00,IN,India,SEARO,0,3,0,0
2020-02-19 00:00:00+00:00,IN,India,SEARO,0,3,0,0
2020-02-20 00:00:00+00:00,IN,India,SEARO,0,3,0,0
2020-02-21 00:00:00+00:00,IN,India,SEARO,0,3,0,0
2020-02-22 00:00:00+00:00,IN,India,SEARO,0,3,0,0
2020-02-23 00:00:00+00:00,IN,India,SEARO,0,3,0,0
2020-02-24 00:00:00+00:00,IN,India,SEARO,0,3,0,0
2020-02-25 00:00:00+00:00,IN,India,SEARO,0,3,0,0
2020-02-26 00:00:00+00:00,IN,India,SEARO,0,3,0,0
2020-02-27 00:00:00+00:00,IN,India,SEARO,0,3,0,0
2020-02-28 00:00:00+00:00,IN,India,SEARO,0,3,0,0
2020-02-29 00:00:00+00:00,IN,India,SEARO,0,3,0,0
2020-03-01 00:00:00+00:00,IN,India,SEARO,0,3,0,0
2020-03-02 00:00:00+00:00,IN,India,SEARO,2,5,0,0
2020-03-03 00:00:00+00:00,IN,India,SEARO,0,5,0,0
2020-03-04 00:00:00+00:00,IN,India,SEARO,22,27,0,0
2020-03-05 00:00:00+00:00,IN,India,SEARO,2,29,0,0
2020-03-06 00:00:00+00:00,IN,India,SEARO,2,31,0,0
2020-03-07 00:00:00+00:00,IN,India,SEARO,3,34,0,0
2020-03-08 00:00:00+00:00,IN,India,SEARO,5,39,0,0
2020-03-09 00:00:00+00:00,IN,India,SEARO,5,44,0,0
2020-03-10 00:00:00+00:00,IN,India,SEARO,6,50,0,0
2020-03-11 00:00:00+00:00,IN,India,SEARO,10,60,0,0
2020-03-12 00:00:00+00:00,IN,India,SEARO,14,74,0,0
2020-03-13 00:00:00+00:00,IN,India,SEARO,7,81,1,1
2020-03-14 00:00:00+00:00,IN,India,SEARO,3,84,1,2
2020-03-15 00:00:00+00:00,IN,India,SEARO,23,107,0,2
2020-03-16 00:00:00+00:00,IN,India,SEARO,7,114,0,2
2020-03-17 00:00:00+00:00,IN,India,SEARO,23,137,1,3
2020-03-18 00:00:00+00:00,IN,India,SEARO,14,151,0,3
2020-03-19 00:00:00+00:00,IN,India,SEARO,44,195,1,4
2020-03-20 00:00:00+00:00,IN,India,SEARO,0,195,0,4
2020-03-21 00:00:00+00:00,IN,India,SEARO,88,283,0,4
2020-03-22 00:00:00+00:00,IN,India,SEARO,58,341,1,5
2020-03-23 00:00:00+00:00,IN,India,SEARO,93,434,4,9
2020-03-24 00:00:00+00:00,IN,India,SEARO,85,519,0,9
2020-03-25 00:00:00+00:00,IN,India,SEARO,87,606,1,10
2020-03-26 00:00:00+00:00,IN,India,SEARO,43,649,3,13
2020-03-27 00:00:00+00:00,IN,India,SEARO,75,724,4,17
2020-03-28 00:00:00+00:00,IN,India,SEARO,0,724,0,17
2020-03-29 00:00:00+00:00,IN,India,SEARO,255,979,8,25
2020-03-30 00:00:00+00:00,IN,India,SEARO,92,1071,4,29
2020-03-31 00:00:00+00:00,IN,India,SEARO,180,1251,3,32
2020-04-01 00:00:00+00:00,IN,India,SEARO,385,1636,6,38
2020-04-02 00:00:00+00:00,IN,India,SEARO,329,1965,12,50
2020-04-03 00:00:00+00:00,IN,India,SEARO,336,2301,6,56
2020-04-04 00:00:00+00:00,IN,India,SEARO,601,2902,12,68
2020-04-05 00:00:00+00:00,IN,India,SEARO,472,3374,9,77
2020-04-06 00:00:00+00:00,IN,India,SEARO,693,4067,32,109
2020-04-07 00:00:00+00:00,IN,India,SEARO,354,4421,5,114
2020-04-08 00:00:00+00:00,IN,India,SEARO,853,5274,35,149
2020-04-09 00:00:00+00:00,IN,India,SEARO,591,5865,20,169
2020-04-10 00:00:00+00:00,IN,India,SEARO,547,6412,30,199
2020-04-11 00:00:00+00:00,IN,India,SEARO,1035,7447,40,239
2020-04-12 00:00:00+00:00,IN,India,SEARO,909,8356,34,273
2020-04-13 00:00:00+00:00,IN,India,SEARO,796,9152,35,308
2020-04-14 00:00:00+00:00,IN,India,SEARO,1211,10363,31,339
2020-04-15 00:00:00+00:00,IN,India,SEARO,1076,11439,38,377
2020-04-16 00:00:00+00:00,IN,India,SEARO,941,12380,37,414
2020-04-17 00:00:00+00:00,IN,India,SEARO,1007,13387,23,437
2020-04-18 00:00:00+00:00,IN,India,SEARO,991,14378,43,480
2020-04-19 00:00:00+00:00,IN,India,SEARO,1334,15712,27,507
2020-04-20 00:00:00+00:00,IN,India,SEARO,1553,17265,36,543
2020-04-21 00:00:00+00:00,IN,India,SEARO,1336,18601,47,590
2020-04-22 00:00:00+00:00,IN,India,SEARO,1383,19984,50,640
2020-04-23 00:00:00+00:00,IN,India,SEARO,1409,21393,41,681
2020-04-24 00:00:00+00:00,IN,India,SEARO,1684,23077,37,718
2020-04-25 00:00:00+00:00,IN,India,SEARO,1429,24506,57,775
2020-04-26 00:00:00+00:00,IN,India,SEARO,1990,26496,49,824
2020-04-27 00:00:00+00:00,IN,India,SEARO,1396,27892,48,872
2020-04-28 00:00:00+00:00,IN,India,SEARO,1543,29435,62,934
2020-04-29 00:00:00+00:00,IN,India,SEARO,1897,31332,73,1007
2020-04-30 00:00:00+00:00,IN,India,SEARO,1718,33050,67,1074
2020-05-01 00:00:00+00:00,IN,India,SEARO,1993,35043,73,1147
2020-05-02 00:00:00+00:00,IN,India,SEARO,2293,37336,71,1218
2020-05-03 00:00:00+00:00,IN,India,SEARO,2644,39980,83,1301
2020-05-04 00:00:00+00:00,IN,India,SEARO,2553,42533,72,1373
2020-05-05 00:00:00+00:00,IN,India,SEARO,3900,46433,195,1568
2020-05-06 00:00:00+00:00,IN,India,SEARO,2958,49391,126,1694
2020-05-07 00:00:00+00:00,IN,India,SEARO,3561,52952,89,1783
2020-05-08 00:00:00+00:00,IN,India,SEARO,3390,56342,103,1886
2020-05-09 00:00:00+00:00,IN,India,SEARO,3320,59662,95,1981
2020-05-10 00:00:00+00:00,IN,India,SEARO,3277,62939,128,2109
2020-05-11 00:00:00+00:00,IN,India,SEARO,4213,67152,97,2206
2020-05-12 00:00:00+00:00,IN,India,SEARO,3604,70756,87,2293
2020-05-13 00:00:00+00:00,IN,India,SEARO,3525,74281,122,2415
2020-05-14 00:00:00+00:00,IN,India,SEARO,3722,78003,134,2549
2020-05-15 00:00:00+00:00,IN,India,SEARO,3967,81970,100,2649
2020-05-16 00:00:00+00:00,IN,India,SEARO,3970,85940,103,2752
2020-05-17 00:00:00+00:00,IN,India,SEARO,4987,90927,120,2872
2020-05-18 00:00:00+00:00,IN,India,SEARO,5242,96169,157,3029
2020-05-19 00:00:00+00:00,IN,India,SEARO,4970,101139,134,3163
2020-05-20 00:00:00+00:00,IN,India,SEARO,5611,106750,140,3303
2020-05-21 00:00:00+00:00,IN,India,SEARO,5609,112359,132,3435
2020-05-22 00:00:00+00:00,IN,India,SEARO,6088,118447,148,3583
2020-05-23 00:00:00+00:00,IN,India,SEARO,6654,125101,137,3720
2020-05-24 00:00:00+00:00,IN,India,SEARO,6767,131868,147,3867
2020-05-25 00:00:00+00:00,IN,India,SEARO,6977,138845,154,4021
2020-05-26 00:00:00+00:00,IN,India,SEARO,6535,145380,146,4167
2020-05-27 00:00:00+00:00,IN,India,SEARO,6387,151767,170,4337
2020-05-28 00:00:00+00:00,IN,India,SEARO,6566,158333,194,4531
2020-05-29 00:00:00+00:00,IN,India,SEARO,7466,165799,175,4706
2020-05-30 00:00:00+00:00,IN,India,SEARO,7964,173763,265,4971
2020-05-31 00:00:00+00:00,IN,India,SEARO,8380,182143,193,5164
2020-06-01 00:00:00+00:00,IN,India,SEARO,8392,190535,230,5394
2020-06-02 00:00:00+00:00,IN,India,SEARO,8171,198706,204,5598
2020-06-03 00:00:00+00:00,IN,India,SEARO,8909,207615,217,5815
2020-06-04 00:00:00+00:00,IN,India,SEARO,9304,216919,260,6075
2020-06-05 00:00:00+00:00,IN,India,SEARO,9851,226770,273,6348
2020-06-06 00:00:00+00:00,IN,India,SEARO,9887,236657,294,6642
2020-06-07 00:00:00+00:00,IN,India,SEARO,9971,246628,287,6929
2020-06-08 00:00:00+00:00,IN,India,SEARO,9983,256611,206,7135
2020-06-09 00:00:00+00:00,IN,India,SEARO,9987,266598,331,7466
2020-06-10 00:00:00+00:00,IN,India,SEARO,9985,276583,279,7745
2020-06-11 00:00:00+00:00,IN,India,SEARO,9996,286579,357,8102
2020-06-12 00:00:00+00:00,IN,India,SEARO,10956,297535,396,8498
2020-03-02 00:00:00+00:00,ID,Indonesia,SEARO,2,2,0,0
2020-03-03 00:00:00+00:00,ID,Indonesia,SEARO,0,2,0,0
2020-03-04 00:00:00+00:00,ID,Indonesia,SEARO,0,2,0,0
2020-03-05 00:00:00+00:00,ID,Indonesia,SEARO,0,2,0,0
2020-03-06 00:00:00+00:00,ID,Indonesia,SEARO,2,4,0,0
2020-03-07 00:00:00+00:00,ID,Indonesia,SEARO,0,4,0,0
2020-03-08 00:00:00+00:00,ID,Indonesia,SEARO,2,6,0,0
2020-03-09 00:00:00+00:00,ID,Indonesia,SEARO,0,6,0,0
2020-03-10 00:00:00+00:00,ID,Indonesia,SEARO,13,19,0,0
2020-03-11 00:00:00+00:00,ID,Indonesia,SEARO,8,27,1,1
2020-03-12 00:00:00+00:00,ID,Indonesia,SEARO,7,34,0,1
2020-03-13 00:00:00+00:00,ID,Indonesia,SEARO,35,69,3,4
2020-03-14 00:00:00+00:00,ID,Indonesia,SEARO,0,69,0,4
2020-03-15 00:00:00+00:00,ID,Indonesia,SEARO,48,117,0,4
2020-03-16 00:00:00+00:00,ID,Indonesia,SEARO,55,172,1,5
2020-03-17 00:00:00+00:00,ID,Indonesia,SEARO,0,172,0,5
2020-03-18 00:00:00+00:00,ID,Indonesia,SEARO,55,227,14,19
2020-03-19 00:00:00+00:00,ID,Indonesia,SEARO,82,309,6,25
2020-03-20 00:00:00+00:00,ID,Indonesia,SEARO,60,369,7,32
2020-03-21 00:00:00+00:00,ID,Indonesia,SEARO,81,450,6,38
2020-03-22 00:00:00+00:00,ID,Indonesia,SEARO,64,514,10,48
2020-03-23 00:00:00+00:00,ID,Indonesia,SEARO,65,579,1,49
2020-03-24 00:00:00+00:00,ID,Indonesia,SEARO,0,579,0,49
2020-03-25 00:00:00+00:00,ID,Indonesia,SEARO,211,790,9,58
2020-03-26 00:00:00+00:00,ID,Indonesia,SEARO,103,893,20,78
2020-03-27 00:00:00+00:00,ID,Indonesia,SEARO,153,1046,9,87
2020-03-28 00:00:00+00:00,ID,Indonesia,SEARO,0,1046,0,87
2020-03-29 00:00:00+00:00,ID,Indonesia,SEARO,239,1285,27,114
2020-03-30 00:00:00+00:00,ID,Indonesia,SEARO,129,1414,8,122
2020-03-31 00:00:00+00:00,ID,Indonesia,SEARO,114,1528,14,136
2020-04-01 00:00:00+00:00,ID,Indonesia,SEARO,149,1677,21,157
2020-04-02 00:00:00+00:00,ID,Indonesia,SEARO,113,1790,13,170
2020-04-03 00:00:00+00:00,ID,Indonesia,SEARO,196,1986,11,181
2020-04-04 00:00:00+00:00,ID,Indonesia,SEARO,106,2092,10,191
2020-04-05 00:00:00+00:00,ID,Indonesia,SEARO,181,2273,7,198
2020-04-06 00:00:00+00:00,ID,Indonesia,SEARO,218,2491,11,209
2020-04-07 00:00:00+00:00,ID,Indonesia,SEARO,247,2738,12,221
2020-04-08 00:00:00+00:00,ID,Indonesia,SEARO,218,2956,19,240
2020-04-09 00:00:00+00:00,ID,Indonesia,SEARO,337,3293,40,280
2020-04-10 00:00:00+00:00,ID,Indonesia,SEARO,219,3512,26,306
2020-04-11 00:00:00+00:00,ID,Indonesia,SEARO,330,3842,21,327
2020-04-12 00:00:00+00:00,ID,Indonesia,SEARO,399,4241,46,373
2020-04-13 00:00:00+00:00,ID,Indonesia,SEARO,316,4557,26,399
2020-04-14 00:00:00+00:00,ID,Indonesia,SEARO,282,4839,60,459
2020-04-15 00:00:00+00:00,ID,Indonesia,SEARO,297,5136,10,469
2020-04-16 00:00:00+00:00,ID,Indonesia,SEARO,380,5516,27,496
2020-04-17 00:00:00+00:00,ID,Indonesia,SEARO,407,5923,24,520
2020-04-18 00:00:00+00:00,ID,Indonesia,SEARO,325,6248,15,535
2020-04-19 00:00:00+00:00,ID,Indonesia,SEARO,327,6575,47,582
2020-04-20 00:00:00+00:00,ID,Indonesia,SEARO,185,6760,8,590
2020-04-21 00:00:00+00:00,ID,Indonesia,SEARO,375,7135,26,616
2020-04-22 00:00:00+00:00,ID,Indonesia,SEARO,283,7418,19,635
2020-04-23 00:00:00+00:00,ID,Indonesia,SEARO,357,7775,12,647
2020-04-24 00:00:00+00:00,ID,Indonesia,SEARO,436,8211,42,689
2020-04-25 00:00:00+00:00,ID,Indonesia,SEARO,396,8607,31,720
2020-04-26 00:00:00+00:00,ID,Indonesia,SEARO,275,8882,23,743
2020-04-27 00:00:00+00:00,ID,Indonesia,SEARO,214,9096,22,765
2020-04-28 00:00:00+00:00,ID,Indonesia,SEARO,415,9511,8,773
2020-04-29 00:00:00+00:00,ID,Indonesia,SEARO,260,9771,11,784
2020-04-30 00:00:00+00:00,ID,Indonesia,SEARO,347,10118,8,792
2020-05-01 00:00:00+00:00,ID,Indonesia,SEARO,433,10551,8,800
2020-05-02 00:00:00+00:00,ID,Indonesia,SEARO,292,10843,31,831
2020-05-03 00:00:00+00:00,ID,Indonesia,SEARO,349,11192,14,845
2020-05-04 00:00:00+00:00,ID,Indonesia,SEARO,395,11587,19,864
2020-05-05 00:00:00+00:00,ID,Indonesia,SEARO,484,12071,8,872
2020-05-06 00:00:00+00:00,ID,Indonesia,SEARO,367,12438,23,895
2020-05-07 00:00:00+00:00,ID,Indonesia,SEARO,338,12776,35,930
2020-05-08 00:00:00+00:00,ID,Indonesia,SEARO,336,13112,13,943
2020-05-09 00:00:00+00:00,ID,Indonesia,SEARO,533,13645,16,959
2020-05-10 00:00:00+00:00,ID,Indonesia,SEARO,387,14032,14,973
2020-05-11 00:00:00+00:00,ID,Indonesia,SEARO,233,14265,18,991
2020-05-12 00:00:00+00:00,ID,Indonesia,SEARO,484,14749,16,1007
2020-05-13 00:00:00+00:00,ID,Indonesia,SEARO,689,15438,21,1028
2020-05-14 00:00:00+00:00,ID,Indonesia,SEARO,568,16006,15,1043
2020-05-15 00:00:00+00:00,ID,Indonesia,SEARO,490,16496,33,1076
2020-05-16 00:00:00+00:00,ID,Indonesia,SEARO,529,17025,13,1089
2020-05-17 00:00:00+00:00,ID,Indonesia,SEARO,489,17514,59,1148
2020-05-18 00:00:00+00:00,ID,Indonesia,SEARO,496,18010,43,1191
2020-05-19 00:00:00+00:00,ID,Indonesia,SEARO,486,18496,30,1221
2020-05-20 00:00:00+00:00,ID,Indonesia,SEARO,693,19189,21,1242
2020-05-21 00:00:00+00:00,ID,Indonesia,SEARO,973,20162,36,1278
2020-05-22 00:00:00+00:00,ID,Indonesia,SEARO,634,20796,48,1326
2020-05-23 00:00:00+00:00,ID,Indonesia,SEARO,949,21745,25,1351
2020-05-24 00:00:00+00:00,ID,Indonesia,SEARO,526,22271,21,1372
2020-05-25 00:00:00+00:00,ID,Indonesia,SEARO,479,22750,19,1391
2020-05-26 00:00:00+00:00,ID,Indonesia,SEARO,415,23165,27,1418
2020-05-27 00:00:00+00:00,ID,Indonesia,SEARO,686,23851,55,1473
2020-05-28 00:00:00+00:00,ID,Indonesia,SEARO,687,24538,23,1496
2020-05-29 00:00:00+00:00,ID,Indonesia,SEARO,678,25216,24,1520
2020-05-30 00:00:00+00:00,ID,Indonesia,SEARO,557,25773,53,1573
2020-05-31 00:00:00+00:00,ID,Indonesia,SEARO,700,26473,40,1613
2020-06-01 00:00:00+00:00,ID,Indonesia,SEARO,0,26473,0,1613
2020-06-02 00:00:00+00:00,ID,Indonesia,SEARO,467,26940,28,1641
2020-06-03 00:00:00+00:00,ID,Indonesia,SEARO,609,27549,22,1663
2020-06-04 00:00:00+00:00,ID,Indonesia,SEARO,684,28233,35,1698
2020-06-05 00:00:00+00:00,ID,Indonesia,SEARO,585,28818,23,1721
2020-06-06 00:00:00+00:00,ID,Indonesia,SEARO,703,29521,49,1770
2020-06-07 00:00:00+00:00,ID,Indonesia,SEARO,993,30514,31,1801
2020-06-08 00:00:00+00:00,ID,Indonesia,SEARO,672,31186,50,1851
2020-06-09 00:00:00+00:00,ID,Indonesia,SEARO,847,32033,32,1883
2020-06-10 00:00:00+00:00,ID,Indonesia,SEARO,1043,33076,40,1923
2020-06-11 00:00:00+00:00,ID,Indonesia,SEARO,1240,34316,36,1959
2020-06-12 00:00:00+00:00,ID,Indonesia,SEARO,979,35295,41,2000
2020-03-07 00:00:00+00:00,MV,Maldives,SEARO,2,2,0,0
2020-03-08 00:00:00+00:00,MV,Maldives,SEARO,2,4,0,0
2020-03-09 00:00:00+00:00,MV,Maldives,SEARO,0,4,0,0
2020-03-10 00:00:00+00:00,MV,Maldives,SEARO,2,6,0,0
2020-03-11 00:00:00+00:00,MV,Maldives,SEARO,2,8,0,0
2020-03-12 00:00:00+00:00,MV,Maldives,SEARO,0,8,0,0
2020-03-13 00:00:00+00:00,MV,Maldives,SEARO,0,8,0,0
2020-03-14 00:00:00+00:00,MV,Maldives,SEARO,1,9,0,0
2020-03-15 00:00:00+00:00,MV,Maldives,SEARO,4,13,0,0
2020-03-16 00:00:00+00:00,MV,Maldives,SEARO,0,13,0,0
2020-03-17 00:00:00+00:00,MV,Maldives,SEARO,0,13,0,0
2020-03-18 00:00:00+00:00,MV,Maldives,SEARO,0,13,0,0
2020-03-19 00:00:00+00:00,MV,Maldives,SEARO,0,13,0,0
2020-03-20 00:00:00+00:00,MV,Maldives,SEARO,0,13,0,0
2020-03-21 00:00:00+00:00,MV,Maldives,SEARO,0,13,0,0
2020-03-22 00:00:00+00:00,MV,Maldives,SEARO,0,13,0,0
2020-03-23 00:00:00+00:00,MV,Maldives,SEARO,0,13,0,0
2020-03-24 00:00:00+00:00,MV,Maldives,SEARO,0,13,0,0
2020-03-25 00:00:00+00:00,MV,Maldives,SEARO,0,13,0,0
2020-03-26 00:00:00+00:00,MV,Maldives,SEARO,0,13,0,0
2020-03-27 00:00:00+00:00,MV,Maldives,SEARO,0,13,0,0
2020-03-28 00:00:00+00:00,MV,Maldives,SEARO,0,13,0,0
2020-03-29 00:00:00+00:00,MV,Maldives,SEARO,3,16,0,0
2020-03-30 00:00:00+00:00,MV,Maldives,SEARO,1,17,0,0
2020-03-31 00:00:00+00:00,MV,Maldives,SEARO,0,17,0,0
2020-04-01 00:00:00+00:00,MV,Maldives,SEARO,1,18,0,0
2020-04-02 00:00:00+00:00,MV,Maldives,SEARO,1,19,0,0
2020-04-03 00:00:00+00:00,MV,Maldives,SEARO,0,19,0,0
2020-04-04 00:00:00+00:00,MV,Maldives,SEARO,0,19,0,0
2020-04-05 00:00:00+00:00,MV,Maldives,SEARO,0,19,0,0
2020-04-06 00:00:00+00:00,MV,Maldives,SEARO,0,19,0,0
2020-04-07 00:00:00+00:00,MV,Maldives,SEARO,0,19,0,0
2020-04-08 00:00:00+00:00,MV,Maldives,SEARO,0,19,0,0
2020-04-09 00:00:00+00:00,MV,Maldives,SEARO,0,19,0,0
2020-04-10 00:00:00+00:00,MV,Maldives,SEARO,0,19,0,0
2020-04-11 00:00:00+00:00,MV,Maldives,SEARO,0,19,0,0
2020-04-12 00:00:00+00:00,MV,Maldives,SEARO,1,20,0,0
2020-04-13 00:00:00+00:00,MV,Maldives,SEARO,0,20,0,0
2020-04-14 00:00:00+00:00,MV,Maldives,SEARO,0,20,0,0
2020-04-15 00:00:00+00:00,MV,Maldives,SEARO,1,21,0,0
2020-04-16 00:00:00+00:00,MV,Maldives,SEARO,2,23,0,0
2020-04-17 00:00:00+00:00,MV,Maldives,SEARO,5,28,0,0
2020-04-18 00:00:00+00:00,MV,Maldives,SEARO,6,34,0,0
2020-04-19 00:00:00+00:00,MV,Maldives,SEARO,17,51,0,0
2020-04-20 00:00:00+00:00,MV,Maldives,SEARO,9,60,0,0
2020-04-21 00:00:00+00:00,MV,Maldives,SEARO,23,83,0,0
2020-04-22 00:00:00+00:00,MV,Maldives,SEARO,2,85,0,0
2020-04-23 00:00:00+00:00,MV,Maldives,SEARO,9,94,0,0
2020-04-24 00:00:00+00:00,MV,Maldives,SEARO,22,116,0,0
2020-04-25 00:00:00+00:00,MV,Maldives,SEARO,21,137,0,0
2020-04-26 00:00:00+00:00,MV,Maldives,SEARO,51,188,0,0
2020-04-27 00:00:00+00:00,MV,Maldives,SEARO,26,214,0,0
2020-04-28 00:00:00+00:00,MV,Maldives,SEARO,31,245,0,0
2020-04-29 00:00:00+00:00,MV,Maldives,SEARO,11,256,0,0
2020-04-30 00:00:00+00:00,MV,Maldives,SEARO,140,396,0,0
2020-05-01 00:00:00+00:00,MV,Maldives,SEARO,72,468,1,1
2020-05-02 00:00:00+00:00,MV,Maldives,SEARO,23,491,0,1
2020-05-03 00:00:00+00:00,MV,Maldives,SEARO,28,519,0,1
2020-05-04 00:00:00+00:00,MV,Maldives,SEARO,8,527,0,1
2020-05-05 00:00:00+00:00,MV,Maldives,SEARO,30,557,0,1
2020-05-06 00:00:00+00:00,MV,Maldives,SEARO,61,618,1,2
2020-05-07 00:00:00+00:00,MV,Maldives,SEARO,0,618,0,2
2020-05-08 00:00:00+00:00,MV,Maldives,SEARO,30,648,1,3
2020-05-09 00:00:00+00:00,MV,Maldives,SEARO,96,744,0,3
2020-05-10 00:00:00+00:00,MV,Maldives,SEARO,41,785,0,3
2020-05-11 00:00:00+00:00,MV,Maldives,SEARO,50,835,0,3
2020-05-12 00:00:00+00:00,MV,Maldives,SEARO,62,897,0,3
2020-05-13 00:00:00+00:00,MV,Maldives,SEARO,7,904,0,3
2020-05-14 00:00:00+00:00,MV,Maldives,SEARO,64,968,1,4
2020-05-15 00:00:00+00:00,MV,Maldives,SEARO,52,1020,0,4
2020-05-16 00:00:00+00:00,MV,Maldives,SEARO,58,1078,0,4
2020-05-17 00:00:00+00:00,MV,Maldives,SEARO,0,1078,0,4
2020-05-18 00:00:00+00:00,MV,Maldives,SEARO,16,1094,0,4
2020-05-19 00:00:00+00:00,MV,Maldives,SEARO,49,1143,0,4
2020-05-20 00:00:00+00:00,MV,Maldives,SEARO,43,1186,0,4
2020-05-21 00:00:00+00:00,MV,Maldives,SEARO,30,1216,0,4
2020-05-22 00:00:00+00:00,MV,Maldives,SEARO,0,1216,0,4
2020-05-23 00:00:00+00:00,MV,Maldives,SEARO,58,1274,0,4
2020-05-24 00:00:00+00:00,MV,Maldives,SEARO,39,1313,0,4
2020-05-25 00:00:00+00:00,MV,Maldives,SEARO,82,1395,0,4
2020-05-26 00:00:00+00:00,MV,Maldives,SEARO,0,1395,0,4
2020-05-27 00:00:00+00:00,MV,Maldives,SEARO,62,1457,1,5
2020-05-28 00:00:00+00:00,MV,Maldives,SEARO,0,1457,0,5
2020-05-29 00:00:00+00:00,MV,Maldives,SEARO,56,1513,0,5
2020-05-30 00:00:00+00:00,MV,Maldives,SEARO,120,1633,0,5
2020-05-31 00:00:00+00:00,MV,Maldives,SEARO,39,1672,0,5
2020-06-01 00:00:00+00:00,MV,Maldives,SEARO,101,1773,0,5
2020-06-02 00:00:00+00:00,MV,Maldives,SEARO,56,1829,1,6
2020-06-03 00:00:00+00:00,MV,Maldives,SEARO,12,1841,1,7
2020-06-04 00:00:00+00:00,MV,Maldives,SEARO,9,1850,0,7
2020-06-05 00:00:00+00:00,MV,Maldives,SEARO,22,1872,0,7
2020-06-06 00:00:00+00:00,MV,Maldives,SEARO,11,1883,0,7
2020-06-07 00:00:00+00:00,MV,Maldives,SEARO,18,1901,1,8
2020-06-08 00:00:00+00:00,MV,Maldives,SEARO,2,1903,0,8
2020-06-09 00:00:00+00:00,MV,Maldives,SEARO,13,1916,0,8
2020-06-10 00:00:00+00:00,MV,Maldives,SEARO,26,1942,0,8
2020-06-11 00:00:00+00:00,MV,Maldives,SEARO,20,1962,0,8
2020-06-12 00:00:00+00:00,MV,Maldives,SEARO,14,1976,0,8
2020-03-24 00:00:00+00:00,MM,Myanmar,SEARO,2,2,0,0
2020-03-25 00:00:00+00:00,MM,Myanmar,SEARO,1,3,0,0
2020-03-26 00:00:00+00:00,MM,Myanmar,SEARO,0,3,0,0
2020-03-27 00:00:00+00:00,MM,Myanmar,SEARO,2,5,0,0
2020-03-28 00:00:00+00:00,MM,Myanmar,SEARO,0,5,0,0
2020-03-29 00:00:00+00:00,MM,Myanmar,SEARO,3,8,0,0
2020-03-30 00:00:00+00:00,MM,Myanmar,SEARO,2,10,0,0
2020-03-31 00:00:00+00:00,MM,Myanmar,SEARO,4,14,0,0
2020-04-01 00:00:00+00:00,MM,Myanmar,SEARO,1,15,1,1
2020-04-02 00:00:00+00:00,MM,Myanmar,SEARO,1,16,0,1
2020-04-03 00:00:00+00:00,MM,Myanmar,SEARO,4,20,0,1
2020-04-04 00:00:00+00:00,MM,Myanmar,SEARO,0,20,0,1
2020-04-05 00:00:00+00:00,MM,Myanmar,SEARO,1,21,0,1
2020-04-06 00:00:00+00:00,MM,Myanmar,SEARO,0,21,0,1
2020-04-07 00:00:00+00:00,MM,Myanmar,SEARO,1,22,0,1
2020-04-08 00:00:00+00:00,MM,Myanmar,SEARO,0,22,2,3
2020-04-09 00:00:00+00:00,MM,Myanmar,SEARO,0,22,0,3
2020-04-10 00:00:00+00:00,MM,Myanmar,SEARO,5,27,0,3
2020-04-11 00:00:00+00:00,MM,Myanmar,SEARO,1,28,0,3
2020-04-12 00:00:00+00:00,MM,Myanmar,SEARO,10,38,0,3
2020-04-13 00:00:00+00:00,MM,Myanmar,SEARO,3,41,1,4
2020-04-14 00:00:00+00:00,MM,Myanmar,SEARO,21,62,0,4
2020-04-15 00:00:00+00:00,MM,Myanmar,SEARO,12,74,0,4
2020-04-16 00:00:00+00:00,MM,Myanmar,SEARO,11,85,0,4
2020-04-17 00:00:00+00:00,MM,Myanmar,SEARO,0,85,0,4
2020-04-18 00:00:00+00:00,MM,Myanmar,SEARO,9,94,1,5
2020-04-19 00:00:00+00:00,MM,Myanmar,SEARO,13,107,0,5
2020-04-20 00:00:00+00:00,MM,Myanmar,SEARO,4,111,0,5
2020-04-21 00:00:00+00:00,MM,Myanmar,SEARO,8,119,0,5
2020-04-22 00:00:00+00:00,MM,Myanmar,SEARO,2,121,0,5
2020-04-23 00:00:00+00:00,MM,Myanmar,SEARO,6,127,0,5
2020-04-24 00:00:00+00:00,MM,Myanmar,SEARO,12,139,0,5
2020-04-25 00:00:00+00:00,MM,Myanmar,SEARO,5,144,0,5
2020-04-26 00:00:00+00:00,MM,Myanmar,SEARO,2,146,0,5
2020-04-27 00:00:00+00:00,MM,Myanmar,SEARO,0,146,0,5
2020-04-28 00:00:00+00:00,MM,Myanmar,SEARO,0,146,0,5
2020-04-29 00:00:00+00:00,MM,Myanmar,SEARO,4,150,0,5
2020-04-30 00:00:00+00:00,MM,Myanmar,SEARO,0,150,1,6
2020-05-01 00:00:00+00:00,MM,Myanmar,SEARO,1,151,0,6
2020-05-02 00:00:00+00:00,MM,Myanmar,SEARO,0,151,0,6
2020-05-03 00:00:00+00:00,MM,Myanmar,SEARO,0,151,0,6
2020-05-04 00:00:00+00:00,MM,Myanmar,SEARO,4,155,0,6
2020-05-05 00:00:00+00:00,MM,Myanmar,SEARO,6,161,0,6
2020-05-06 00:00:00+00:00,MM,Myanmar,SEARO,0,161,0,6
2020-05-07 00:00:00+00:00,MM,Myanmar,SEARO,1,162,0,6
2020-05-08 00:00:00+00:00,MM,Myanmar,SEARO,14,176,0,6
2020-05-09 00:00:00+00:00,MM,Myanmar,SEARO,1,177,0,6
2020-05-10 00:00:00+00:00,MM,Myanmar,SEARO,1,178,0,6
2020-05-11 00:00:00+00:00,MM,Myanmar,SEARO,2,180,0,6
2020-05-12 00:00:00+00:00,MM,Myanmar,SEARO,0,180,0,6
2020-05-13 00:00:00+00:00,MM,Myanmar,SEARO,0,180,0,6
2020-05-14 00:00:00+00:00,MM,Myanmar,SEARO,1,181,0,6
2020-05-15 00:00:00+00:00,MM,Myanmar,SEARO,0,181,0,6
2020-05-16 00:00:00+00:00,MM,Myanmar,SEARO,1,182,0,6
2020-05-17 00:00:00+00:00,MM,Myanmar,SEARO,2,184,0,6
2020-05-18 00:00:00+00:00,MM,Myanmar,SEARO,4,188,0,6
2020-05-19 00:00:00+00:00,MM,Myanmar,SEARO,3,191,0,6
2020-05-20 00:00:00+00:00,MM,Myanmar,SEARO,2,193,0,6
2020-05-21 00:00:00+00:00,MM,Myanmar,SEARO,6,199,0,6
2020-05-22 00:00:00+00:00,MM,Myanmar,SEARO,0,199,0,6
2020-05-23 00:00:00+00:00,MM,Myanmar,SEARO,2,201,0,6
2020-05-24 00:00:00+00:00,MM,Myanmar,SEARO,0,201,0,6
2020-05-25 00:00:00+00:00,MM,Myanmar,SEARO,0,201,0,6
2020-05-26 00:00:00+00:00,MM,Myanmar,SEARO,5,206,0,6
2020-05-27 00:00:00+00:00,MM,Myanmar,SEARO,0,206,0,6
2020-05-28 00:00:00+00:00,MM,Myanmar,SEARO,0,206,0,6
2020-05-29 00:00:00+00:00,MM,Myanmar,SEARO,0,206,0,6
2020-05-30 00:00:00+00:00,MM,Myanmar,SEARO,18,224,0,6
2020-05-31 00:00:00+00:00,MM,Myanmar,SEARO,0,224,0,6
2020-06-01 00:00:00+00:00,MM,Myanmar,SEARO,0,224,0,6
2020-06-02 00:00:00+00:00,MM,Myanmar,SEARO,4,228,0,6
2020-06-03 00:00:00+00:00,MM,Myanmar,SEARO,5,233,0,6
2020-06-04 00:00:00+00:00,MM,Myanmar,SEARO,1,234,0,6
2020-06-05 00:00:00+00:00,MM,Myanmar,SEARO,2,236,0,6
2020-06-06 00:00:00+00:00,MM,Myanmar,SEARO,0,236,0,6
2020-06-07 00:00:00+00:00,MM,Myanmar,SEARO,4,240,0,6
2020-06-08 00:00:00+00:00,MM,Myanmar,SEARO,2,242,0,6
2020-06-09 00:00:00+00:00,MM,Myanmar,SEARO,2,244,0,6
2020-06-10 00:00:00+00:00,MM,Myanmar,SEARO,2,246,0,6
2020-06-11 00:00:00+00:00,MM,Myanmar,SEARO,2,248,0,6
2020-06-12 00:00:00+00:00,MM,Myanmar,SEARO,13,261,0,6
2020-01-23 00:00:00+00:00,NP,Nepal,SEARO,1,1,0,0
2020-01-24 00:00:00+00:00,NP,Nepal,SEARO,0,1,0,0
2020-01-25 00:00:00+00:00,NP,Nepal,SEARO,0,1,0,0
2020-01-26 00:00:00+00:00,NP,Nepal,SEARO,0,1,0,0
2020-01-27 00:00:00+00:00,NP,Nepal,SEARO,0,1,0,0
2020-01-28 00:00:00+00:00,NP,Nepal,SEARO,0,1,0,0
2020-01-29 00:00:00+00:00,NP,Nepal,SEARO,0,1,0,0
2020-01-30 00:00:00+00:00,NP,Nepal,SEARO,0,1,0,0
2020-01-31 00:00:00+00:00,NP,Nepal,SEARO,0,1,0,0
2020-02-01 00:00:00+00:00,NP,Nepal,SEARO,0,1,0,0
2020-02-02 00:00:00+00:00,NP,Nepal,SEARO,0,1,0,0
2020-02-03 00:00:00+00:00,NP,Nepal,SEARO,0,1,0,0
2020-02-04 00:00:00+00:00,NP,Nepal,SEARO,0,1,0,0
2020-02-05 00:00:00+00:00,NP,Nepal,SEARO,0,1,0,0
2020-02-06 00:00:00+00:00,NP,Nepal,SEARO,0,1,0,0
2020-02-07 00:00:00+00:00,NP,Nepal,SEARO,0,1,0,0
2020-02-08 00:00:00+00:00,NP,Nepal,SEARO,0,1,0,0
2020-02-09 00:00:00+00:00,NP,Nepal,SEARO,0,1,0,0
2020-02-10 00:00:00+00:00,NP,Nepal,SEARO,0,1,0,0
2020-02-11 00:00:00+00:00,NP,Nepal,SEARO,0,1,0,0
2020-02-12 00:00:00+00:00,NP,Nepal,SEARO,0,1,0,0
2020-02-13 00:00:00+00:00,NP,Nepal,SEARO,0,1,0,0
2020-02-14 00:00:00+00:00,NP,Nepal,SEARO,0,1,0,0
2020-02-15 00:00:00+00:00,NP,Nepal,SEARO,0,1,0,0
2020-02-16 00:00:00+00:00,NP,Nepal,SEARO,0,1,0,0
2020-02-17 00:00:00+00:00,NP,Nepal,SEARO,0,1,0,0
2020-02-18 00:00:00+00:00,NP,Nepal,SEARO,0,1,0,0
2020-02-19 00:00:00+00:00,NP,Nepal,SEARO,0,1,0,0
2020-02-20 00:00:00+00:00,NP,Nepal,SEARO,0,1,0,0
2020-02-21 00:00:00+00:00,NP,Nepal,SEARO,0,1,0,0
2020-02-22 00:00:00+00:00,NP,Nepal,SEARO,0,1,0,0
2020-02-23 00:00:00+00:00,NP,Nepal,SEARO,0,1,0,0
2020-02-24 00:00:00+00:00,NP,Nepal,SEARO,0,1,0,0
2020-02-25 00:00:00+00:00,NP,Nepal,SEARO,0,1,0,0
2020-02-26 00:00:00+00:00,NP,Nepal,SEARO,0,1,0,0
2020-02-27 00:00:00+00:00,NP,Nepal,SEARO,0,1,0,0
2020-02-28 00:00:00+00:00,NP,Nepal,SEARO,0,1,0,0
2020-02-29 00:00:00+00:00,NP,Nepal,SEARO,0,1,0,0
2020-03-01 00:00:00+00:00,NP,Nepal,SEARO,0,1,0,0
2020-03-02 00:00:00+00:00,NP,Nepal,SEARO,0,1,0,0
2020-03-03 00:00:00+00:00,NP,Nepal,SEARO,0,1,0,0
2020-03-04 00:00:00+00:00,NP,Nepal,SEARO,0,1,0,0
2020-03-05 00:00:00+00:00,NP,Nepal,SEARO,0,1,0,0
2020-03-06 00:00:00+00:00,NP,Nepal,SEARO,0,1,0,0
2020-03-07 00:00:00+00:00,NP,Nepal,SEARO,0,1,0,0
2020-03-08 00:00:00+00:00,NP,Nepal,SEARO,0,1,0,0
2020-03-09 00:00:00+00:00,NP,Nepal,SEARO,0,1,0,0
2020-03-10 00:00:00+00:00,NP,Nepal,SEARO,0,1,0,0
2020-03-11 00:00:00+00:00,NP,Nepal,SEARO,0,1,0,0
2020-03-12 00:00:00+00:00,NP,Nepal,SEARO,0,1,0,0
2020-03-13 00:00:00+00:00,NP,Nepal,SEARO,0,1,0,0
2020-03-14 00:00:00+00:00,NP,Nepal,SEARO,0,1,0,0
2020-03-15 00:00:00+00:00,NP,Nepal,SEARO,0,1,0,0
2020-03-16 00:00:00+00:00,NP,Nepal,SEARO,0,1,0,0
2020-03-17 00:00:00+00:00,NP,Nepal,SEARO,0,1,0,0
2020-03-18 00:00:00+00:00,NP,Nepal,SEARO,0,1,0,0
2020-03-19 00:00:00+00:00,NP,Nepal,SEARO,0,1,0,0
2020-03-20 00:00:00+00:00,NP,Nepal,SEARO,0,1,0,0
2020-03-21 00:00:00+00:00,NP,Nepal,SEARO,0,1,0,0
2020-03-22 00:00:00+00:00,NP,Nepal,SEARO,0,1,0,0
2020-03-23 00:00:00+00:00,NP,Nepal,SEARO,0,1,0,0
2020-03-24 00:00:00+00:00,NP,Nepal,SEARO,1,2,0,0
2020-03-25 00:00:00+00:00,NP,Nepal,SEARO,0,2,0,0
2020-03-26 00:00:00+00:00,NP,Nepal,SEARO,1,3,0,0
2020-03-27 00:00:00+00:00,NP,Nepal,SEARO,0,3,0,0
2020-03-28 00:00:00+00:00,NP,Nepal,SEARO,0,3,0,0
2020-03-29 00:00:00+00:00,NP,Nepal,SEARO,2,5,0,0
2020-03-30 00:00:00+00:00,NP,Nepal,SEARO,0,5,0,0
2020-03-31 00:00:00+00:00,NP,Nepal,SEARO,0,5,0,0
2020-04-01 00:00:00+00:00,NP,Nepal,SEARO,0,5,0,0
2020-04-02 00:00:00+00:00,NP,Nepal,SEARO,0,5,0,0
2020-04-03 00:00:00+00:00,NP,Nepal,SEARO,1,6,0,0
2020-04-04 00:00:00+00:00,NP,Nepal,SEARO,0,6,0,0
2020-04-05 00:00:00+00:00,NP,Nepal,SEARO,3,9,0,0
2020-04-06 00:00:00+00:00,NP,Nepal,SEARO,0,9,0,0
2020-04-07 00:00:00+00:00,NP,Nepal,SEARO,0,9,0,0
2020-04-08 00:00:00+00:00,NP,Nepal,SEARO,0,9,0,0
2020-04-09 00:00:00+00:00,NP,Nepal,SEARO,0,9,0,0
2020-04-10 00:00:00+00:00,NP,Nepal,SEARO,0,9,0,0
2020-04-11 00:00:00+00:00,NP,Nepal,SEARO,0,9,0,0
2020-04-12 00:00:00+00:00,NP,Nepal,SEARO,3,12,0,0
2020-04-13 00:00:00+00:00,NP,Nepal,SEARO,2,14,0,0
2020-04-14 00:00:00+00:00,NP,Nepal,SEARO,2,16,0,0
2020-04-15 00:00:00+00:00,NP,Nepal,SEARO,0,16,0,0
2020-04-16 00:00:00+00:00,NP,Nepal,SEARO,0,16,0,0
2020-04-17 00:00:00+00:00,NP,Nepal,SEARO,0,16,0,0
2020-04-18 00:00:00+00:00,NP,Nepal,SEARO,14,30,0,0
2020-04-19 00:00:00+00:00,NP,Nepal,SEARO,1,31,0,0
2020-04-20 00:00:00+00:00,NP,Nepal,SEARO,0,31,0,0
2020-04-21 00:00:00+00:00,NP,Nepal,SEARO,1,32,0,0
2020-04-22 00:00:00+00:00,NP,Nepal,SEARO,10,42,0,0
2020-04-23 00:00:00+00:00,NP,Nepal,SEARO,3,45,0,0
2020-04-24 00:00:00+00:00,NP,Nepal,SEARO,3,48,0,0
2020-04-25 00:00:00+00:00,NP,Nepal,SEARO,1,49,0,0
2020-04-26 00:00:00+00:00,NP,Nepal,SEARO,2,51,0,0
2020-04-27 00:00:00+00:00,NP,Nepal,SEARO,1,52,0,0
2020-04-28 00:00:00+00:00,NP,Nepal,SEARO,0,52,0,0
2020-04-29 00:00:00+00:00,NP,Nepal,SEARO,5,57,0,0
2020-04-30 00:00:00+00:00,NP,Nepal,SEARO,0,57,0,0
2020-05-01 00:00:00+00:00,NP,Nepal,SEARO,2,59,0,0
2020-05-02 00:00:00+00:00,NP,Nepal,SEARO,0,59,0,0
2020-05-03 00:00:00+00:00,NP,Nepal,SEARO,10,69,0,0
2020-05-04 00:00:00+00:00,NP,Nepal,SEARO,6,75,0,0
2020-05-05 00:00:00+00:00,NP,Nepal,SEARO,7,82,0,0
2020-05-06 00:00:00+00:00,NP,Nepal,SEARO,17,99,0,0
2020-05-07 00:00:00+00:00,NP,Nepal,SEARO,0,99,0,0
2020-05-08 00:00:00+00:00,NP,Nepal,SEARO,3,102,0,0
2020-05-09 00:00:00+00:00,NP,Nepal,SEARO,7,109,0,0
2020-05-10 00:00:00+00:00,NP,Nepal,SEARO,1,110,0,0
2020-05-11 00:00:00+00:00,NP,Nepal,SEARO,11,121,0,0
2020-05-12 00:00:00+00:00,NP,Nepal,SEARO,70,191,0,0
2020-05-13 00:00:00+00:00,NP,Nepal,SEARO,52,243,0,0
2020-05-14 00:00:00+00:00,NP,Nepal,SEARO,6,249,0,0
2020-05-15 00:00:00+00:00,NP,Nepal,SEARO,9,258,0,0
2020-05-16 00:00:00+00:00,NP,Nepal,SEARO,23,281,1,1
2020-05-17 00:00:00+00:00,NP,Nepal,SEARO,14,295,1,2
2020-05-18 00:00:00+00:00,NP,Nepal,SEARO,62,357,0,2
2020-05-19 00:00:00+00:00,NP,Nepal,SEARO,45,402,0,2
2020-05-20 00:00:00+00:00,NP,Nepal,SEARO,25,427,0,2
2020-05-21 00:00:00+00:00,NP,Nepal,SEARO,27,454,1,3
2020-05-22 00:00:00+00:00,NP,Nepal,SEARO,62,516,0,3
2020-05-23 00:00:00+00:00,NP,Nepal,SEARO,68,584,0,3
2020-05-24 00:00:00+00:00,NP,Nepal,SEARO,19,603,0,3
2020-05-25 00:00:00+00:00,NP,Nepal,SEARO,79,682,1,4
2020-05-26 00:00:00+00:00,NP,Nepal,SEARO,90,772,0,4
2020-05-27 00:00:00+00:00,NP,Nepal,SEARO,114,886,0,4
2020-05-28 00:00:00+00:00,NP,Nepal,SEARO,156,1042,1,5
2020-05-29 00:00:00+00:00,NP,Nepal,SEARO,170,1212,1,6
2020-05-30 00:00:00+00:00,NP,Nepal,SEARO,189,1401,0,6
2020-05-31 00:00:00+00:00,NP,Nepal,SEARO,171,1572,2,8
2020-06-01 00:00:00+00:00,NP,Nepal,SEARO,0,1572,0,8
2020-06-02 00:00:00+00:00,NP,Nepal,SEARO,239,1811,0,8
2020-06-03 00:00:00+00:00,NP,Nepal,SEARO,288,2099,0,8
2020-06-04 00:00:00+00:00,NP,Nepal,SEARO,201,2300,1,9
2020-06-05 00:00:00+00:00,NP,Nepal,SEARO,334,2634,1,10
2020-06-06 00:00:00+00:00,NP,Nepal,SEARO,278,2912,1,11
2020-06-07 00:00:00+00:00,NP,Nepal,SEARO,323,3235,2,13
2020-06-08 00:00:00+00:00,NP,Nepal,SEARO,213,3448,0,13
2020-06-09 00:00:00+00:00,NP,Nepal,SEARO,314,3762,1,14
2020-06-10 00:00:00+00:00,NP,Nepal,SEARO,323,4085,1,15
2020-06-11 00:00:00+00:00,NP,Nepal,SEARO,279,4364,0,15
2020-06-12 00:00:00+00:00,NP,Nepal,SEARO,250,4614,0,15
2020-01-27 00:00:00+00:00,LK,Sri Lanka,SEARO,1,1,0,0
2020-01-28 00:00:00+00:00,LK,Sri Lanka,SEARO,0,1,0,0
2020-01-29 00:00:00+00:00,LK,Sri Lanka,SEARO,0,1,0,0
2020-01-30 00:00:00+00:00,LK,Sri Lanka,SEARO,0,1,0,0
2020-01-31 00:00:00+00:00,LK,Sri Lanka,SEARO,0,1,0,0
2020-02-01 00:00:00+00:00,LK,Sri Lanka,SEARO,0,1,0,0
2020-02-02 00:00:00+00:00,LK,Sri Lanka,SEARO,0,1,0,0
2020-02-03 00:00:00+00:00,LK,Sri Lanka,SEARO,0,1,0,0
2020-02-04 00:00:00+00:00,LK,Sri Lanka,SEARO,0,1,0,0
2020-02-05 00:00:00+00:00,LK,Sri Lanka,SEARO,0,1,0,0
2020-02-06 00:00:00+00:00,LK,Sri Lanka,SEARO,0,1,0,0
2020-02-07 00:00:00+00:00,LK,Sri Lanka,SEARO,0,1,0,0
2020-02-08 00:00:00+00:00,LK,Sri Lanka,SEARO,0,1,0,0
2020-02-09 00:00:00+00:00,LK,Sri Lanka,SEARO,0,1,0,0
2020-02-10 00:00:00+00:00,LK,Sri Lanka,SEARO,0,1,0,0
2020-02-11 00:00:00+00:00,LK,Sri Lanka,SEARO,0,1,0,0
2020-02-12 00:00:00+00:00,LK,Sri Lanka,SEARO,0,1,0,0
2020-02-13 00:00:00+00:00,LK,Sri Lanka,SEARO,0,1,0,0
2020-02-14 00:00:00+00:00,LK,Sri Lanka,SEARO,0,1,0,0
2020-02-15 00:00:00+00:00,LK,Sri Lanka,SEARO,0,1,0,0
2020-02-16 00:00:00+00:00,LK,Sri Lanka,SEARO,0,1,0,0
2020-02-17 00:00:00+00:00,LK,Sri Lanka,SEARO,0,1,0,0
2020-02-18 00:00:00+00:00,LK,Sri Lanka,SEARO,0,1,0,0
2020-02-19 00:00:00+00:00,LK,Sri Lanka,SEARO,0,1,0,0
2020-02-20 00:00:00+00:00,LK,Sri Lanka,SEARO,0,1,0,0
2020-02-21 00:00:00+00:00,LK,Sri Lanka,SEARO,0,1,0,0
2020-02-22 00:00:00+00:00,LK,Sri Lanka,SEARO,0,1,0,0
2020-02-23 00:00:00+00:00,LK,Sri Lanka,SEARO,0,1,0,0
2020-02-24 00:00:00+00:00,LK,Sri Lanka,SEARO,0,1,0,0
2020-02-25 00:00:00+00:00,LK,Sri Lanka,SEARO,0,1,0,0
2020-02-26 00:00:00+00:00,LK,Sri Lanka,SEARO,0,1,0,0
2020-02-27 00:00:00+00:00,LK,Sri Lanka,SEARO,0,1,0,0
2020-02-28 00:00:00+00:00,LK,Sri Lanka,SEARO,0,1,0,0
2020-02-29 00:00:00+00:00,LK,Sri Lanka,SEARO,0,1,0,0
2020-03-01 00:00:00+00:00,LK,Sri Lanka,SEARO,0,1,0,0
2020-03-02 00:00:00+00:00,LK,Sri Lanka,SEARO,0,1,0,0
2020-03-03 00:00:00+00:00,LK,Sri Lanka,SEARO,0,1,0,0
2020-03-04 00:00:00+00:00,LK,Sri Lanka,SEARO,0,1,0,0
2020-03-05 00:00:00+00:00,LK,Sri Lanka,SEARO,0,1,0,0
2020-03-06 00:00:00+00:00,LK,Sri Lanka,SEARO,0,1,0,0
2020-03-07 00:00:00+00:00,LK,Sri Lanka,SEARO,0,1,0,0
2020-03-08 00:00:00+00:00,LK,Sri Lanka,SEARO,0,1,0,0
2020-03-09 00:00:00+00:00,LK,Sri Lanka,SEARO,0,1,0,0
2020-03-10 00:00:00+00:00,LK,Sri Lanka,SEARO,0,1,0,0
2020-03-11 00:00:00+00:00,LK,Sri Lanka,SEARO,1,2,0,0
2020-03-12 00:00:00+00:00,LK,Sri Lanka,SEARO,1,3,0,0
2020-03-13 00:00:00+00:00,LK,Sri Lanka,SEARO,0,3,0,0
2020-03-14 00:00:00+00:00,LK,Sri Lanka,SEARO,3,6,0,0
2020-03-15 00:00:00+00:00,LK,Sri Lanka,SEARO,5,11,0,0
2020-03-16 00:00:00+00:00,LK,Sri Lanka,SEARO,8,19,0,0
2020-03-17 00:00:00+00:00,LK,Sri Lanka,SEARO,10,29,0,0
2020-03-18 00:00:00+00:00,LK,Sri Lanka,SEARO,13,42,0,0
2020-03-19 00:00:00+00:00,LK,Sri Lanka,SEARO,17,59,0,0
2020-03-20 00:00:00+00:00,LK,Sri Lanka,SEARO,0,59,0,0
2020-03-21 00:00:00+00:00,LK,Sri Lanka,SEARO,13,72,0,0
2020-03-22 00:00:00+00:00,LK,Sri Lanka,SEARO,0,72,0,0
2020-03-23 00:00:00+00:00,LK,Sri Lanka,SEARO,22,94,0,0
2020-03-24 00:00:00+00:00,LK,Sri Lanka,SEARO,3,97,0,0
2020-03-25 00:00:00+00:00,LK,Sri Lanka,SEARO,5,102,0,0
2020-03-26 00:00:00+00:00,LK,Sri Lanka,SEARO,0,102,0,0
2020-03-27 00:00:00+00:00,LK,Sri Lanka,SEARO,4,106,0,0
2020-03-28 00:00:00+00:00,LK,Sri Lanka,SEARO,0,106,0,0
2020-03-29 00:00:00+00:00,LK,Sri Lanka,SEARO,9,115,1,1
2020-03-30 00:00:00+00:00,LK,Sri Lanka,SEARO,5,120,0,1
2020-03-31 00:00:00+00:00,LK,Sri Lanka,SEARO,2,122,1,2
2020-04-01 00:00:00+00:00,LK,Sri Lanka,SEARO,21,143,0,2
2020-04-02 00:00:00+00:00,LK,Sri Lanka,SEARO,5,148,1,3
2020-04-03 00:00:00+00:00,LK,Sri Lanka,SEARO,3,151,1,4
2020-04-04 00:00:00+00:00,LK,Sri Lanka,SEARO,8,159,1,5
2020-04-05 00:00:00+00:00,LK,Sri Lanka,SEARO,7,166,0,5
2020-04-06 00:00:00+00:00,LK,Sri Lanka,SEARO,10,176,0,5
2020-04-07 00:00:00+00:00,LK,Sri Lanka,SEARO,4,180,1,6
2020-04-08 00:00:00+00:00,LK,Sri Lanka,SEARO,6,186,0,6
2020-04-09 00:00:00+00:00,LK,Sri Lanka,SEARO,3,189,1,7
2020-04-10 00:00:00+00:00,LK,Sri Lanka,SEARO,1,190,0,7
2020-04-11 00:00:00+00:00,LK,Sri Lanka,SEARO,7,197,0,7
2020-04-12 00:00:00+00:00,LK,Sri Lanka,SEARO,2,199,0,7
2020-04-13 00:00:00+00:00,LK,Sri Lanka,SEARO,11,210,0,7
2020-04-14 00:00:00+00:00,LK,Sri Lanka,SEARO,8,218,0,7
2020-04-15 00:00:00+00:00,LK,Sri Lanka,SEARO,15,233,0,7
2020-04-16 00:00:00+00:00,LK,Sri Lanka,SEARO,5,238,0,7
2020-04-17 00:00:00+00:00,LK,Sri Lanka,SEARO,0,238,0,7
2020-04-18 00:00:00+00:00,LK,Sri Lanka,SEARO,6,244,0,7
2020-04-19 00:00:00+00:00,LK,Sri Lanka,SEARO,10,254,0,7
2020-04-20 00:00:00+00:00,LK,Sri Lanka,SEARO,17,271,0,7
2020-04-21 00:00:00+00:00,LK,Sri Lanka,SEARO,33,304,0,7
2020-04-22 00:00:00+00:00,LK,Sri Lanka,SEARO,6,310,0,7
2020-04-23 00:00:00+00:00,LK,Sri Lanka,SEARO,20,330,0,7
2020-04-24 00:00:00+00:00,LK,Sri Lanka,SEARO,38,368,0,7
2020-04-25 00:00:00+00:00,LK,Sri Lanka,SEARO,52,420,0,7
2020-04-26 00:00:00+00:00,LK,Sri Lanka,SEARO,40,460,0,7
2020-04-27 00:00:00+00:00,LK,Sri Lanka,SEARO,63,523,0,7
2020-04-28 00:00:00+00:00,LK,Sri Lanka,SEARO,65,588,0,7
2020-04-29 00:00:00+00:00,LK,Sri Lanka,SEARO,31,619,0,7
2020-04-30 00:00:00+00:00,LK,Sri Lanka,SEARO,30,649,0,7
2020-05-01 00:00:00+00:00,LK,Sri Lanka,SEARO,16,665,0,7
2020-05-02 00:00:00+00:00,LK,Sri Lanka,SEARO,25,690,0,7
2020-05-03 00:00:00+00:00,LK,Sri Lanka,SEARO,15,705,0,7
2020-05-04 00:00:00+00:00,LK,Sri Lanka,SEARO,13,718,0,7
2020-05-05 00:00:00+00:00,LK,Sri Lanka,SEARO,37,755,1,8
2020-05-06 00:00:00+00:00,LK,Sri Lanka,SEARO,16,771,1,9
2020-05-07 00:00:00+00:00,LK,Sri Lanka,SEARO,26,797,0,9
2020-05-08 00:00:00+00:00,LK,Sri Lanka,SEARO,27,824,0,9
2020-05-09 00:00:00+00:00,LK,Sri Lanka,SEARO,11,835,0,9
2020-05-10 00:00:00+00:00,LK,Sri Lanka,SEARO,12,847,0,9
2020-05-11 00:00:00+00:00,LK,Sri Lanka,SEARO,16,863,0,9
2020-05-12 00:00:00+00:00,LK,Sri Lanka,SEARO,6,869,0,9
2020-05-13 00:00:00+00:00,LK,Sri Lanka,SEARO,24,893,0,9
2020-05-14 00:00:00+00:00,LK,Sri Lanka,SEARO,23,916,0,9
2020-05-15 00:00:00+00:00,LK,Sri Lanka,SEARO,9,925,0,9
2020-05-16 00:00:00+00:00,LK,Sri Lanka,SEARO,24,949,0,9
2020-05-17 00:00:00+00:00,LK,Sri Lanka,SEARO,21,970,0,9
2020-05-18 00:00:00+00:00,LK,Sri Lanka,SEARO,16,986,0,9
2020-05-19 00:00:00+00:00,LK,Sri Lanka,SEARO,34,1020,0,9
2020-05-20 00:00:00+00:00,LK,Sri Lanka,SEARO,7,1027,0,9
2020-05-21 00:00:00+00:00,LK,Sri Lanka,SEARO,18,1045,0,9
2020-05-22 00:00:00+00:00,LK,Sri Lanka,SEARO,15,1060,0,9
2020-05-23 00:00:00+00:00,LK,Sri Lanka,SEARO,25,1085,0,9
2020-05-24 00:00:00+00:00,LK,Sri Lanka,SEARO,33,1118,0,9
2020-05-25 00:00:00+00:00,LK,Sri Lanka,SEARO,64,1182,0,9
2020-05-26 00:00:00+00:00,LK,Sri Lanka,SEARO,96,1278,1,10
2020-05-27 00:00:00+00:00,LK,Sri Lanka,SEARO,147,1425,0,10
2020-05-28 00:00:00+00:00,LK,Sri Lanka,SEARO,78,1503,0,10
2020-05-29 00:00:00+00:00,LK,Sri Lanka,SEARO,37,1540,0,10
2020-05-30 00:00:00+00:00,LK,Sri Lanka,SEARO,26,1566,0,10
2020-05-31 00:00:00+00:00,LK,Sri Lanka,SEARO,64,1630,0,10
2020-06-01 00:00:00+00:00,LK,Sri Lanka,SEARO,3,1633,0,10
2020-06-02 00:00:00+00:00,LK,Sri Lanka,SEARO,10,1643,1,11
2020-06-03 00:00:00+00:00,LK,Sri Lanka,SEARO,40,1683,0,11
2020-06-04 00:00:00+00:00,LK,Sri Lanka,SEARO,66,1749,0,11
2020-06-05 00:00:00+00:00,LK,Sri Lanka,SEARO,48,1797,0,11
2020-06-06 00:00:00+00:00,LK,Sri Lanka,SEARO,4,1801,0,11
2020-06-07 00:00:00+00:00,LK,Sri Lanka,SEARO,13,1814,0,11
2020-06-08 00:00:00+00:00,LK,Sri Lanka,SEARO,21,1835,0,11
2020-06-09 00:00:00+00:00,LK,Sri Lanka,SEARO,22,1857,0,11
2020-06-10 00:00:00+00:00,LK,Sri Lanka,SEARO,2,1859,0,11
2020-06-11 00:00:00+00:00,LK,Sri Lanka,SEARO,10,1869,0,11
2020-06-12 00:00:00+00:00,LK,Sri Lanka,SEARO,8,1877,0,11
2020-01-13 00:00:00+00:00,TH,Thailand,SEARO,1,1,0,0
2020-01-14 00:00:00+00:00,TH,Thailand,SEARO,0,1,0,0
2020-01-15 00:00:00+00:00,TH,Thailand,SEARO,0,1,0,0
2020-01-16 00:00:00+00:00,TH,Thailand,SEARO,0,1,0,0
2020-01-17 00:00:00+00:00,TH,Thailand,SEARO,1,2,0,0
2020-01-18 00:00:00+00:00,TH,Thailand,SEARO,0,2,0,0
2020-01-19 00:00:00+00:00,TH,Thailand,SEARO,0,2,0,0
2020-01-20 00:00:00+00:00,TH,Thailand,SEARO,0,2,0,0
2020-01-21 00:00:00+00:00,TH,Thailand,SEARO,0,2,0,0
2020-01-22 00:00:00+00:00,TH,Thailand,SEARO,2,4,0,0
2020-01-23 00:00:00+00:00,TH,Thailand,SEARO,0,4,0,0
2020-01-24 00:00:00+00:00,TH,Thailand,SEARO,0,4,0,0
2020-01-25 00:00:00+00:00,TH,Thailand,SEARO,0,4,0,0
2020-01-26 00:00:00+00:00,TH,Thailand,SEARO,1,5,0,0
2020-01-27 00:00:00+00:00,TH,Thailand,SEARO,3,8,0,0
2020-01-28 00:00:00+00:00,TH,Thailand,SEARO,6,14,0,0
2020-01-29 00:00:00+00:00,TH,Thailand,SEARO,0,14,0,0
2020-01-30 00:00:00+00:00,TH,Thailand,SEARO,0,14,0,0
2020-01-31 00:00:00+00:00,TH,Thailand,SEARO,5,19,0,0
2020-02-01 00:00:00+00:00,TH,Thailand,SEARO,0,19,0,0
2020-02-02 00:00:00+00:00,TH,Thailand,SEARO,0,19,0,0
2020-02-03 00:00:00+00:00,TH,Thailand,SEARO,0,19,0,0
2020-02-04 00:00:00+00:00,TH,Thailand,SEARO,6,25,0,0
2020-02-05 00:00:00+00:00,TH,Thailand,SEARO,0,25,0,0
2020-02-06 00:00:00+00:00,TH,Thailand,SEARO,0,25,0,0
2020-02-07 00:00:00+00:00,TH,Thailand,SEARO,0,25,0,0
2020-02-08 00:00:00+00:00,TH,Thailand,SEARO,7,32,0,0
2020-02-09 00:00:00+00:00,TH,Thailand,SEARO,0,32,0,0
2020-02-10 00:00:00+00:00,TH,Thailand,SEARO,0,32,0,0
2020-02-11 00:00:00+00:00,TH,Thailand,SEARO,1,33,0,0
2020-02-12 00:00:00+00:00,TH,Thailand,SEARO,0,33,0,0
2020-02-13 00:00:00+00:00,TH,Thailand,SEARO,0,33,0,0
2020-02-14 00:00:00+00:00,TH,Thailand,SEARO,0,33,0,0
2020-02-15 00:00:00+00:00,TH,Thailand,SEARO,1,34,0,0
2020-02-16 00:00:00+00:00,TH,Thailand,SEARO,0,34,0,0
2020-02-17 00:00:00+00:00,TH,Thailand,SEARO,1,35,0,0
2020-02-18 00:00:00+00:00,TH,Thailand,SEARO,0,35,0,0
2020-02-19 00:00:00+00:00,TH,Thailand,SEARO,0,35,0,0
2020-02-20 00:00:00+00:00,TH,Thailand,SEARO,0,35,0,0
2020-02-21 00:00:00+00:00,TH,Thailand,SEARO,0,35,0,0
2020-02-22 00:00:00+00:00,TH,Thailand,SEARO,0,35,0,0
2020-02-23 00:00:00+00:00,TH,Thailand,SEARO,0,35,0,0
2020-02-24 00:00:00+00:00,TH,Thailand,SEARO,0,35,0,0
2020-02-25 00:00:00+00:00,TH,Thailand,SEARO,2,37,0,0
2020-02-26 00:00:00+00:00,TH,Thailand,SEARO,3,40,0,0
2020-02-27 00:00:00+00:00,TH,Thailand,SEARO,0,40,0,0
2020-02-28 00:00:00+00:00,TH,Thailand,SEARO,1,41,0,0
2020-02-29 00:00:00+00:00,TH,Thailand,SEARO,1,42,0,0
2020-03-01 00:00:00+00:00,TH,Thailand,SEARO,0,42,1,1
2020-03-02 00:00:00+00:00,TH,Thailand,SEARO,1,43,0,1
2020-03-03 00:00:00+00:00,TH,Thailand,SEARO,0,43,0,1
2020-03-04 00:00:00+00:00,TH,Thailand,SEARO,0,43,0,1
2020-03-05 00:00:00+00:00,TH,Thailand,SEARO,4,47,0,1
2020-03-06 00:00:00+00:00,TH,Thailand,SEARO,1,48,0,1
2020-03-07 00:00:00+00:00,TH,Thailand,SEARO,2,50,0,1
2020-03-08 00:00:00+00:00,TH,Thailand,SEARO,0,50,0,1
2020-03-09 00:00:00+00:00,TH,Thailand,SEARO,0,50,0,1
2020-03-10 00:00:00+00:00,TH,Thailand,SEARO,3,53,0,1
2020-03-11 00:00:00+00:00,TH,Thailand,SEARO,6,59,0,1
2020-03-12 00:00:00+00:00,TH,Thailand,SEARO,11,70,0,1
2020-03-13 00:00:00+00:00,TH,Thailand,SEARO,5,75,0,1
2020-03-14 00:00:00+00:00,TH,Thailand,SEARO,0,75,0,1
2020-03-15 00:00:00+00:00,TH,Thailand,SEARO,39,114,0,1
2020-03-16 00:00:00+00:00,TH,Thailand,SEARO,33,147,0,1
2020-03-17 00:00:00+00:00,TH,Thailand,SEARO,30,177,0,1
2020-03-18 00:00:00+00:00,TH,Thailand,SEARO,35,212,0,1
2020-03-19 00:00:00+00:00,TH,Thailand,SEARO,110,322,0,1
2020-03-20 00:00:00+00:00,TH,Thailand,SEARO,0,322,0,1
2020-03-21 00:00:00+00:00,TH,Thailand,SEARO,89,411,0,1
2020-03-22 00:00:00+00:00,TH,Thailand,SEARO,188,599,0,1
2020-03-23 00:00:00+00:00,TH,Thailand,SEARO,122,721,0,1
2020-03-24 00:00:00+00:00,TH,Thailand,SEARO,106,827,3,4
2020-03-25 00:00:00+00:00,TH,Thailand,SEARO,107,934,0,4
2020-03-26 00:00:00+00:00,TH,Thailand,SEARO,111,1045,0,4
2020-03-27 00:00:00+00:00,TH,Thailand,SEARO,91,1136,1,5
2020-03-28 00:00:00+00:00,TH,Thailand,SEARO,0,1136,0,5
2020-03-29 00:00:00+00:00,TH,Thailand,SEARO,252,1388,2,7
2020-03-30 00:00:00+00:00,TH,Thailand,SEARO,136,1524,2,9
2020-03-31 00:00:00+00:00,TH,Thailand,SEARO,127,1651,1,10
2020-04-01 00:00:00+00:00,TH,Thailand,SEARO,120,1771,2,12
2020-04-02 00:00:00+00:00,TH,Thailand,SEARO,104,1875,3,15
2020-04-03 00:00:00+00:00,TH,Thailand,SEARO,103,1978,4,19
2020-04-04 00:00:00+00:00,TH,Thailand,SEARO,89,2067,1,20
2020-04-05 00:00:00+00:00,TH,Thailand,SEARO,102,2169,3,23
2020-04-06 00:00:00+00:00,TH,Thailand,SEARO,51,2220,3,26
2020-04-07 00:00:00+00:00,TH,Thailand,SEARO,38,2258,1,27
2020-04-08 00:00:00+00:00,TH,Thailand,SEARO,111,2369,3,30
2020-04-09 00:00:00+00:00,TH,Thailand,SEARO,54,2423,2,32
2020-04-10 00:00:00+00:00,TH,Thailand,SEARO,50,2473,1,33
2020-04-11 00:00:00+00:00,TH,Thailand,SEARO,45,2518,2,35
2020-04-12 00:00:00+00:00,TH,Thailand,SEARO,33,2551,3,38
2020-04-13 00:00:00+00:00,TH,Thailand,SEARO,28,2579,2,40
2020-04-14 00:00:00+00:00,TH,Thailand,SEARO,34,2613,1,41
2020-04-15 00:00:00+00:00,TH,Thailand,SEARO,30,2643,2,43
2020-04-16 00:00:00+00:00,TH,Thailand,SEARO,29,2672,3,46
2020-04-17 00:00:00+00:00,TH,Thailand,SEARO,28,2700,1,47
2020-04-18 00:00:00+00:00,TH,Thailand,SEARO,33,2733,0,47
2020-04-19 00:00:00+00:00,TH,Thailand,SEARO,32,2765,0,47
2020-04-20 00:00:00+00:00,TH,Thailand,SEARO,27,2792,0,47
2020-04-21 00:00:00+00:00,TH,Thailand,SEARO,19,2811,1,48
2020-04-22 00:00:00+00:00,TH,Thailand,SEARO,15,2826,1,49
2020-04-23 00:00:00+00:00,TH,Thailand,SEARO,13,2839,1,50
2020-04-24 00:00:00+00:00,TH,Thailand,SEARO,15,2854,0,50
2020-04-25 00:00:00+00:00,TH,Thailand,SEARO,53,2907,1,51
2020-04-26 00:00:00+00:00,TH,Thailand,SEARO,15,2922,0,51
2020-04-27 00:00:00+00:00,TH,Thailand,SEARO,9,2931,1,52
2020-04-28 00:00:00+00:00,TH,Thailand,SEARO,7,2938,2,54
2020-04-29 00:00:00+00:00,TH,Thailand,SEARO,9,2947,0,54
2020-04-30 00:00:00+00:00,TH,Thailand,SEARO,7,2954,0,54
2020-05-01 00:00:00+00:00,TH,Thailand,SEARO,6,2960,0,54
2020-05-02 00:00:00+00:00,TH,Thailand,SEARO,6,2966,0,54
2020-05-03 00:00:00+00:00,TH,Thailand,SEARO,3,2969,0,54
2020-05-04 00:00:00+00:00,TH,Thailand,SEARO,18,2987,0,54
2020-05-05 00:00:00+00:00,TH,Thailand,SEARO,1,2988,0,54
2020-05-06 00:00:00+00:00,TH,Thailand,SEARO,1,2989,1,55
2020-05-07 00:00:00+00:00,TH,Thailand,SEARO,3,2992,0,55
2020-05-08 00:00:00+00:00,TH,Thailand,SEARO,8,3000,0,55
2020-05-09 00:00:00+00:00,TH,Thailand,SEARO,4,3004,1,56
2020-05-10 00:00:00+00:00,TH,Thailand,SEARO,5,3009,0,56
2020-05-11 00:00:00+00:00,TH,Thailand,SEARO,6,3015,0,56
2020-05-12 00:00:00+00:00,TH,Thailand,SEARO,2,3017,0,56
2020-05-13 00:00:00+00:00,TH,Thailand,SEARO,0,3017,0,56
2020-05-14 00:00:00+00:00,TH,Thailand,SEARO,1,3018,0,56
2020-05-15 00:00:00+00:00,TH,Thailand,SEARO,7,3025,0,56
2020-05-16 00:00:00+00:00,TH,Thailand,SEARO,0,3025,0,56
2020-05-17 00:00:00+00:00,TH,Thailand,SEARO,3,3028,0,56
2020-05-18 00:00:00+00:00,TH,Thailand,SEARO,3,3031,0,56
2020-05-19 00:00:00+00:00,TH,Thailand,SEARO,2,3033,0,56
2020-05-20 00:00:00+00:00,TH,Thailand,SEARO,1,3034,0,56
2020-05-21 00:00:00+00:00,TH,Thailand,SEARO,3,3037,0,56
2020-05-22 00:00:00+00:00,TH,Thailand,SEARO,0,3037,0,56
2020-05-23 00:00:00+00:00,TH,Thailand,SEARO,3,3040,0,56
2020-05-24 00:00:00+00:00,TH,Thailand,SEARO,0,3040,0,56
2020-05-25 00:00:00+00:00,TH,Thailand,SEARO,2,3042,1,57
2020-05-26 00:00:00+00:00,TH,Thailand,SEARO,3,3045,0,57
2020-05-27 00:00:00+00:00,TH,Thailand,SEARO,9,3054,0,57
2020-05-28 00:00:00+00:00,TH,Thailand,SEARO,11,3065,0,57
2020-05-29 00:00:00+00:00,TH,Thailand,SEARO,11,3076,0,57
2020-05-30 00:00:00+00:00,TH,Thailand,SEARO,1,3077,0,57
2020-05-31 00:00:00+00:00,TH,Thailand,SEARO,4,3081,0,57
2020-06-01 00:00:00+00:00,TH,Thailand,SEARO,1,3082,0,57
2020-06-02 00:00:00+00:00,TH,Thailand,SEARO,1,3083,1,58
2020-06-03 00:00:00+00:00,TH,Thailand,SEARO,1,3084,0,58
2020-06-04 00:00:00+00:00,TH,Thailand,SEARO,17,3101,0,58
2020-06-05 00:00:00+00:00,TH,Thailand,SEARO,1,3102,0,58
2020-06-06 00:00:00+00:00,TH,Thailand,SEARO,2,3104,0,58
2020-06-07 00:00:00+00:00,TH,Thailand,SEARO,8,3112,0,58
2020-06-08 00:00:00+00:00,TH,Thailand,SEARO,7,3119,0,58
2020-06-09 00:00:00+00:00,TH,Thailand,SEARO,2,3121,0,58
2020-06-10 00:00:00+00:00,TH,Thailand,SEARO,4,3125,0,58
2020-06-11 00:00:00+00:00,TH,Thailand,SEARO,0,3125,0,58
2020-06-12 00:00:00+00:00,TH,Thailand,SEARO,4,3129,0,58
2020-03-20 00:00:00+00:00,TL,Timor-Leste,SEARO,1,1,0,0
2020-03-21 00:00:00+00:00,TL,Timor-Leste,SEARO,0,1,0,0
2020-03-22 00:00:00+00:00,TL,Timor-Leste,SEARO,0,1,0,0
2020-03-23 00:00:00+00:00,TL,Timor-Leste,SEARO,0,1,0,0
2020-03-24 00:00:00+00:00,TL,Timor-Leste,SEARO,0,1,0,0
2020-03-25 00:00:00+00:00,TL,Timor-Leste,SEARO,0,1,0,0
2020-03-26 00:00:00+00:00,TL,Timor-Leste,SEARO,0,1,0,0
2020-03-27 00:00:00+00:00,TL,Timor-Leste,SEARO,0,1,0,0
2020-03-28 00:00:00+00:00,TL,Timor-Leste,SEARO,0,1,0,0
2020-03-29 00:00:00+00:00,TL,Timor-Leste,SEARO,0,1,0,0
2020-03-30 00:00:00+00:00,TL,Timor-Leste,SEARO,0,1,0,0
2020-03-31 00:00:00+00:00,TL,Timor-Leste,SEARO,0,1,0,0
2020-04-01 00:00:00+00:00,TL,Timor-Leste,SEARO,0,1,0,0
2020-04-02 00:00:00+00:00,TL,Timor-Leste,SEARO,0,1,0,0
2020-04-03 00:00:00+00:00,TL,Timor-Leste,SEARO,0,1,0,0
2020-04-04 00:00:00+00:00,TL,Timor-Leste,SEARO,0,1,0,0
2020-04-05 00:00:00+00:00,TL,Timor-Leste,SEARO,0,1,0,0
2020-04-06 00:00:00+00:00,TL,Timor-Leste,SEARO,0,1,0,0
2020-04-07 00:00:00+00:00,TL,Timor-Leste,SEARO,0,1,0,0
2020-04-08 00:00:00+00:00,TL,Timor-Leste,SEARO,0,1,0,0
2020-04-09 00:00:00+00:00,TL,Timor-Leste,SEARO,0,1,0,0
2020-04-10 00:00:00+00:00,TL,Timor-Leste,SEARO,0,1,0,0
2020-04-11 00:00:00+00:00,TL,Timor-Leste,SEARO,1,2,0,0
2020-04-12 00:00:00+00:00,TL,Timor-Leste,SEARO,0,2,0,0
2020-04-13 00:00:00+00:00,TL,Timor-Leste,SEARO,2,4,0,0
2020-04-14 00:00:00+00:00,TL,Timor-Leste,SEARO,2,6,0,0
2020-04-15 00:00:00+00:00,TL,Timor-Leste,SEARO,0,6,0,0
2020-04-16 00:00:00+00:00,TL,Timor-Leste,SEARO,12,18,0,0
2020-04-17 00:00:00+00:00,TL,Timor-Leste,SEARO,0,18,0,0
2020-04-18 00:00:00+00:00,TL,Timor-Leste,SEARO,0,18,0,0
2020-04-19 00:00:00+00:00,TL,Timor-Leste,SEARO,1,19,0,0
2020-04-20 00:00:00+00:00,TL,Timor-Leste,SEARO,3,22,0,0
2020-04-21 00:00:00+00:00,TL,Timor-Leste,SEARO,1,23,0,0
2020-04-22 00:00:00+00:00,TL,Timor-Leste,SEARO,0,23,0,0
2020-04-23 00:00:00+00:00,TL,Timor-Leste,SEARO,0,23,0,0
2020-04-24 00:00:00+00:00,TL,Timor-Leste,SEARO,1,24,0,0
2020-04-25 00:00:00+00:00,TL,Timor-Leste,SEARO,0,24,0,0
2020-04-26 00:00:00+00:00,TL,Timor-Leste,SEARO,0,24,0,0
2020-04-27 00:00:00+00:00,TL,Timor-Leste,SEARO,0,24,0,0
2020-04-28 00:00:00+00:00,TL,Timor-Leste,SEARO,0,24,0,0
2020-04-29 00:00:00+00:00,TL,Timor-Leste,SEARO,0,24,0,0
2020-04-30 00:00:00+00:00,TL,Timor-Leste,SEARO,0,24,0,0
2020-05-01 00:00:00+00:00,TL,Timor-Leste,SEARO,0,24,0,0
2020-05-02 00:00:00+00:00,TL,Timor-Leste,SEARO,0,24,0,0
2020-05-03 00:00:00+00:00,TL,Timor-Leste,SEARO,0,24,0,0
2020-05-04 00:00:00+00:00,TL,Timor-Leste,SEARO,0,24,0,0
2020-05-05 00:00:00+00:00,TL,Timor-Leste,SEARO,0,24,0,0
2020-05-06 00:00:00+00:00,TL,Timor-Leste,SEARO,0,24,0,0
2020-05-07 00:00:00+00:00,TL,Timor-Leste,SEARO,0,24,0,0
2020-05-08 00:00:00+00:00,TL,Timor-Leste,SEARO,0,24,0,0
2020-05-09 00:00:00+00:00,TL,Timor-Leste,SEARO,0,24,0,0
2020-05-10 00:00:00+00:00,TL,Timor-Leste,SEARO,0,24,0,0
2020-05-11 00:00:00+00:00,TL,Timor-Leste,SEARO,0,24,0,0
2020-05-12 00:00:00+00:00,TL,Timor-Leste,SEARO,0,24,0,0
2020-05-13 00:00:00+00:00,TL,Timor-Leste,SEARO,0,24,0,0
2020-05-14 00:00:00+00:00,TL,Timor-Leste,SEARO,0,24,0,0
2020-05-15 00:00:00+00:00,TL,Timor-Leste,SEARO,0,24,0,0
2020-05-16 00:00:00+00:00,TL,Timor-Leste,SEARO,0,24,0,0
2020-05-17 00:00:00+00:00,TL,Timor-Leste,SEARO,0,24,0,0
2020-05-18 00:00:00+00:00,TL,Timor-Leste,SEARO,0,24,0,0
2020-05-19 00:00:00+00:00,TL,Timor-Leste,SEARO,0,24,0,0
2020-05-20 00:00:00+00:00,TL,Timor-Leste,SEARO,0,24,0,0
2020-05-21 00:00:00+00:00,TL,Timor-Leste,SEARO,0,24,0,0
2020-05-22 00:00:00+00:00,TL,Timor-Leste,SEARO,0,24,0,0
2020-05-23 00:00:00+00:00,TL,Timor-Leste,SEARO,0,24,0,0
2020-05-24 00:00:00+00:00,TL,Timor-Leste,SEARO,0,24,0,0
2020-05-25 00:00:00+00:00,TL,Timor-Leste,SEARO,0,24,0,0
2020-05-26 00:00:00+00:00,TL,Timor-Leste,SEARO,0,24,0,0
2020-05-27 00:00:00+00:00,TL,Timor-Leste,SEARO,0,24,0,0
2020-05-28 00:00:00+00:00,TL,Timor-Leste,SEARO,0,24,0,0
2020-05-29 00:00:00+00:00,TL,Timor-Leste,SEARO,0,24,0,0
2020-05-30 00:00:00+00:00,TL,Timor-Leste,SEARO,0,24,0,0
2020-05-31 00:00:00+00:00,TL,Timor-Leste,SEARO,0,24,0,0
2020-06-01 00:00:00+00:00,TL,Timor-Leste,SEARO,0,24,0,0
2020-06-02 00:00:00+00:00,TL,Timor-Leste,SEARO,0,24,0,0
2020-06-03 00:00:00+00:00,TL,Timor-Leste,SEARO,0,24,0,0
2020-06-04 00:00:00+00:00,TL,Timor-Leste,SEARO,0,24,0,0
2020-06-05 00:00:00+00:00,TL,Timor-Leste,SEARO,0,24,0,0
2020-06-06 00:00:00+00:00,TL,Timor-Leste,SEARO,0,24,0,0
2020-06-07 00:00:00+00:00,TL,Timor-Leste,SEARO,0,24,0,0
2020-06-08 00:00:00+00:00,TL,Timor-Leste,SEARO,0,24,0,0
2020-06-09 00:00:00+00:00,TL,Timor-Leste,SEARO,0,24,0,0
2020-06-10 00:00:00+00:00,TL,Timor-Leste,SEARO,0,24,0,0
2020-06-11 00:00:00+00:00,TL,Timor-Leste,SEARO,0,24,0,0
2020-06-12 00:00:00+00:00,TL,Timor-Leste,SEARO,0,24,0,0
